Year,Country,Continent,Imports,Exports,Deficit/Surplus
1995,Angola,Africa,2027903203,254290291,-1773612912
1995,Burundi,Africa,20733728,11368447,-9365281
1995,Benin,Africa,9585545,33078356,23492811
1995,Burkina Faso,Africa,255463,31364882,31109419
1995,Central African Republic,Africa,714305,8212625,7498320
1995,Cote d'Ivoire,Africa,207962264,193072441,-14889823
1995,Cameroon,Africa,53711048,79973092,26262044
1995,Democratic Republic of the Congo,Africa,251861379,74053353,-177808026
1995,Republic of the Congo,Africa,204240578,71236786,-133003792
1995,Comoros,Africa,2422789,1084268,-1338521
1995,Cape Verde,Africa,272763,6482726,6209963
1995,Djibouti,Africa,36509,8005107,7968598
1995,Algeria,Africa,1587168906,1154926200,-432242706
1995,Egypt,Africa,646296232,3035671837,2389375605
1995,Eritrea,Africa,359179,16027448,15668269
1995,Ethiopia,Africa,34421330,193601384,159180054
1995,Gabon,Africa,1323209123,52676613,-1270532510
1995,Ghana,Africa,195490320,160407380,-35082940
1995,Guinea,Africa,110367899,76567343,-33800556
1995,Gambia,Africa,2356544,9738348,7381804
1995,Guinea-Bissau,Africa,39563,853843,814280
1995,Equatorial Guinea,Africa,30011424,5237291,-24774133
1995,Kenya,Africa,101377663,108721777,7344114
1995,Liberia,Africa,8422700,37926216,29503516
1995,Morocco,Africa,267820638,627156340,359335702
1995,Madagascar,Africa,35572739,20617467,-14955272
1995,Mali,Africa,5098697,22653810,17555113
1995,Mozambique,Africa,26612049,47844426,21232377
1995,Mauritania,Africa,5876071,42597239,36721168
1995,Mauritius,Africa,265910323,48765963,-217144360
1995,Malawi,Africa,58503914,20660109,-37843805
1995,Niger,Africa,1617064,42728046,41110982
1995,Nigeria,Africa,4314557080,594738957,-3719818123
1995,Rwanda,Africa,1393977,36849968,35455991
1995,Sudan,Africa,46516725,71466416,24949691
1995,Senegal,Africa,5868586,66080437,60211851
1995,Saint Helena,Africa,41887,217955,176068
1995,Sierra Leone,Africa,28326172,16929294,-11396878
1995,Somalia,Africa,90467,7924283,7833816
1995,Sao Tome and Principe,Africa,105199,1729933,1624734
1995,Seychelles,Africa,2867675,12409034,9541359
1995,Chad,Africa,3068489,19792399,16723910
1995,Togo,Africa,32895857,30913335,-1982522
1995,Tunisia,Africa,88586920,330743642,242156722
1995,Tanzania,Africa,22454527,88873227,66418700
1995,Uganda,Africa,7568593,37368250,29799657
1995,South Africa,Africa,2462018186,3046012299,583994113
1995,Zambia,Africa,85600112,42457583,-43142529
1995,Zimbabwe,Africa,104276852,161791014,57514162
1995,French South Antarctic Territory,Antarctica,429839,39310,-390529
1995,Afghanistan,Asia,5494114,3615347,-1878767
1995,United Arab Emirates,Asia,376060288,1939525089,1563464801
1995,Armenia,Asia,15455599,44270636,28815037
1995,Azerbaijan,Asia,750110,35359602,34609492
1995,Bangladesh,Asia,1576793755,367996212,-1208797543
1995,Bahrain,Asia,125633663,194344878,68711215
1995,Brunei,Asia,36977389,178266364,141288975
1995,Bhutan,Asia,142739,461611,318872
1995,Cocos (Keeling) Islands,Asia,45111,190178,145067
1995,China,Asia,36137386010,12431823897,-23705562113
1995,Christmas Island,Asia,134404,4105803,3971399
1995,Cyprus,Asia,19906530,419926983,400020453
1995,Georgia,Asia,10467855,63339539,52871684
1995,Hong Kong,Asia,12196476363,14205635531,2009159168
1995,Indonesia,Asia,7035602271,3967285972,-3068316299
1995,India,Asia,5794087805,3489605212,-2304482593
1995,British Indian Ocean Territory,Asia,416195,1724483,1308288
1995,Iran,Asia,159112,273272667,273113555
1995,Israel,Asia,5960928529,5274093174,-686835355
1995,Jordan,Asia,69546951,412656542,343109591
1995,Japan,Asia,1.19806E+11,66756940372,-53049550119
1995,Kazakhstan,Asia,121801669,62541508,-59260161
1995,Kyrgyzstan,Asia,8081649,39573861,31492212
1995,Cambodia,Asia,5034429,22241093,17206664
1995,South Korea,Asia,24463419057,26658477022,2195057965
1995,Kuwait,Asia,1216148050,1348909628,132761578
1995,Laos,Asia,10895457,1558501,-9336956
1995,Lebanon,Asia,31935708,574066856,542131148
1995,Sri Lanka,Asia,1324950213,273025637,-1051924576
1995,Macau,Asia,869218512,130917459,-738301053
1995,Maldives,Asia,21357565,2015333,-19342232
1995,Burma,Asia,85257506,15761680,-69495826
1995,Mongolia,Asia,24975176,12234863,-12740313
1995,Malaysia,Asia,15781907458,9451328731,-6330578727
1995,Nepal,Asia,107940149,8983909,-98956240
1995,Oman,Asia,359324157,327147673,-32176484
1995,Pakistan,Asia,1255302484,918175747,-337126737
1995,Philippines,Asia,7171082207,5173036713,-1998045494
1995,Qatar,Asia,83226251,216606928,133380677
1995,Saudi Arabia,Asia,7925347895,5659396032,-2265951863
1995,Singapore,Asia,20055029321,16016540000,-4038489321
1995,Syria,Asia,57953407,222389982,164436575
1995,Thailand,Asia,11235987447,7117668071,-4118319376
1995,Tajikistan,Asia,38452163,15796867,-22655296
1995,Turkmenistan,Asia,1219864,32206519,30986655
1995,Turkey,Asia,1722127932,3455622583,1733494651
1995,Uzbekistan,Asia,19187449,49429196,30241747
1995,Vietnam,Asia,194301368,243514725,49213357
1995,Chinese Taipei,Asia,29330961671,18837452349,-10493509322
1995,Yemen,Asia,35943099,183988551,148045452
1995,Albania,Europe,9322819,12712636,3389817
1995,Andorra,Europe,217923,46603055,46385132
1995,Austria,Europe,1837509850,2851560020,1014050170
1995,Bulgaria,Europe,182784985,127419667,-55365318
1995,Bosnia and Herzegovina,Europe,3190181,25500529,22310348
1995,Belarus,Europe,46712189,40921857,-5790332
1995,Belgium-Luxembourg,Europe,6550094668,11139283983,4589189315
1995,Switzerland,Europe,7275060069,6648148237,-626911832
1995,Czechia,Europe,451654697,606036826,154382129
1995,Germany,Europe,37717620107,24124588729,-13593031378
1995,Denmark,Europe,1969910432,1706296498,-263613934
1995,Spain,Europe,3905245982,6626054942,2720808960
1995,Estonia,Europe,81941593,161862775,79921182
1995,Finland,Europe,2729225744,1786720910,-942504834
1995,France,Europe,16495526430,17310363127,814836697
1995,United Kingdom,Europe,26891636704,29287228048,2395591344
1995,Gibraltar,Europe,2566337,15162377,12596040
1995,Greece,Europe,406634301,1198358647,791724346
1995,Croatia,Europe,101698320,213240923,111542603
1995,Hungary,Europe,503218342,430093976,-73124366
1995,Ireland,Europe,4050559301,4483068904,432509603
1995,Iceland,Europe,232077839,163233431,-68844408
1995,Italy,Europe,16844084106,9462291871,-7381792235
1995,Lithuania,Europe,32173168,75796144,43622976
1995,Latvia,Europe,93363771,84637102,-8726669
1995,Moldova,Europe,27984120,15500534,-12483586
1995,North Macedonia,Europe,57360368,59848220,2487852
1995,Malta,Europe,196050304,175716741,-20333563
1995,Netherlands,Europe,6317669435,15414309487,9096640052
1995,Norway,Europe,2788646883,1778369624,-1010277259
1995,Poland,Europe,726907396,1026290531,299383135
1995,Portugal,Europe,1151677549,1139850474,-11827075
1995,Romania,Europe,249350196,390677031,141326835
1995,Russia,Europe,3938536531,2754473730,-1184062801
1995,Slovakia,Europe,137284307,146273985,8989678
1995,Slovenia,Europe,308639590,237531111,-71108479
1995,Sweden,Europe,6272784803,3358416177,-2914368626
1995,Ukraine,Europe,417312703,189576135,-227736568
1995,Aruba,North America,392338289,229816316,-162521973
1995,Anguilla,North America,23016,12160381,12137365
1995,Netherlands Antilles,North America,230545855,470284191,239738336
1995,Antigua and Barbuda,North America,2440520,84664440,82223920
1995,Bahamas,North America,153420796,583955165,430534369
1995,Belize,North America,82116845,138607715,56490870
1995,Bermuda,North America,3875765,414240671,410364906
1995,Barbados,North America,34454556,166457940,132003384
1995,Canada,North America,1.42782E+11,1.15037E+11,-27745353806
1995,Costa Rica,North America,1557678091,1719272697,161594606
1995,Cayman Islands,North America,14493765,135533564,121039799
1995,Dominica,North America,7093803,43433569,36339766
1995,Dominican Republic,North America,3389406412,2930333567,-459072845
1995,Grenada,North America,9420427,51348348,41927921
1995,Greenland,North America,5232891,10276959,5044068
1995,Guatemala,North America,867470378,1750408744,882938366
1995,Honduras,North America,1097944209,1180397912,82453703
1995,Haiti,North America,138549886,498347112,359797226
1995,Jamaica,North America,835233294,1344182844,508949550
1995,Saint Kitts and Nevis,North America,25227956,73941770,48713814
1995,Saint Lucia,North America,35813601,118890078,83076477
1995,Mexico,North America,64996557454,46526952572,-18469604882
1995,Montserrat,North America,1743430,3244152,1500722
1995,Nicaragua,North America,291720498,351666875,59946377
1995,Panama,North America,332785510,1393380909,1060595399
1995,El Salvador,North America,462702005,1302964419,840262414
1995,Saint Pierre and Miquelon,North America,3398912,483413,-2915499
1995,Turks and Caicos Islands,North America,4901202,19159846,14258644
1995,Trinidad and Tobago,North America,1100051759,793821450,-306230309
1995,Saint Vincent and the Grenadines,North America,8962411,66922397,57959986
1995,British Virgin Islands,North America,4765387,43349216,38583829
1995,Australia,Oceania,3472217840,11687394822,8215176982
1995,Cook Islands,Oceania,1065250,837366,-227884
1995,Fiji,Oceania,83448486,25321484,-58127002
1995,Micronesia,Oceania,12969643,19985175,7015532
1995,Kiribati,Oceania,1047729,2244073,1196344
1995,Marshall Islands,Oceania,5087871,27842202,22754331
1995,New Caledonia,Oceania,40865164,18378047,-22487117
1995,Norfolk Island,Oceania,78150873,1119922,-77030951
1995,Niue,Oceania,78493,29946556,29868063
1995,Nauru,Oceania,16102,498806,482704
1995,New Zealand,Oceania,1444695224,2050871935,606176711
1995,Pitcairn Islands,Oceania,27969,2207417,2179448
1995,Palau,Oceania,6248345,7007181,758836
1995,Papua New Guinea,Oceania,47368487,48723386,1354899
1995,French Polynesia,Oceania,13465922,75607625,62141703
1995,Solomon Islands,Oceania,4713409,2049868,-2663541
1995,Tokelau,Oceania,6299140,168400,-6130740
1995,Tonga,Oceania,4269919,5857504,1587585
1995,Vanuatu,Oceania,123058,664271,541213
1995,Wallis and Futuna,Oceania,40290,96761,56471
1995,Samoa,Oceania,312647,6865569,6552922
1995,Argentina,South America,1915726898,4220666804,2304939906
1995,Bolivia,South America,371923642,315103036,-56820606
1995,Brazil,South America,9115783798,12274745725,3158961927
1995,Chile,South America,2201444130,3899542474,1698098344
1995,Colombia,South America,3774885221,5069718908,1294833687
1995,Ecuador,South America,1873645673,1514552305,-359093368
1995,Falkland Islands,South America,455676,16026,-439650
1995,Guyana,South America,114660630,132321158,17660528
1995,Peru,South America,1013940862,2014605402,1000664540
1995,Paraguay,South America,64821422,686826189,622004767
1995,Suriname,South America,113137369,326071587,212934218
1995,Uruguay,South America,141710284,371529528,229819244
1995,Venezuela,South America,9781108424,4452012001,-5329096423
1996,Angola,Africa,2430114457,262376125,-2167738332
1996,Burundi,Africa,1718016,6484067,4766051
1996,Benin,Africa,17600398,26396499,8796101
1996,Burkina Faso,Africa,3815544,28448662,24633118
1996,Central African Republic,Africa,314872,5398046,5083174
1996,Cote d'Ivoire,Africa,401912900,180748429,-221164471
1996,Cameroon,Africa,70777677,105088424,34310747
1996,Democratic Republic of the Congo,Africa,239392997,69720977,-169672020
1996,Republic of the Congo,Africa,291316708,60464569,-230852139
1996,Comoros,Africa,6050363,130680,-5919683
1996,Cape Verde,Africa,386047,66608694,66222647
1996,Djibouti,Africa,7975,7995007,7987032
1996,Algeria,Africa,3061277507,860354633,-2200922874
1996,Egypt,Africa,673894039,3300952204,2627058165
1996,Eritrea,Africa,1654885,13364726,11709841
1996,Ethiopia,Africa,32955007,141930980,108975973
1996,Gabon,Africa,1818279218,81465894,-1736813324
1996,Ghana,Africa,191741420,365099470,173358050
1996,Guinea,Africa,127580106,92692867,-34887239
1996,Gambia,Africa,1947896,14757961,12810065
1996,Guinea-Bissau,Africa,48517,6922589,6874072
1996,Equatorial Guinea,Africa,70866020,16517434,-54348586
1996,Kenya,Africa,106526060,97232704,-9293356
1996,Liberia,Africa,26200553,42712170,16511617
1996,Morocco,Africa,273982739,628811942,354829203
1996,Madagascar,Africa,41879103,26591371,-15287732
1996,Mali,Africa,4657197,38362124,33704927
1996,Mozambique,Africa,25883271,21701089,-4182182
1996,Mauritania,Africa,5595071,14939501,9344430
1996,Mauritius,Africa,262864269,52863912,-210000357
1996,Malawi,Africa,69598409,10760831,-58837578
1996,Niger,Africa,734558,32387748,31653190
1996,Nigeria,Africa,6152955206,1020255072,-5132700134
1996,Rwanda,Africa,8443738,38663979,30220241
1996,Sudan,Africa,19125333,92842107,73716774
1996,Senegal,Africa,4505545,86377376,81871831
1996,Saint Helena,Africa,1863686,12371743,10508057
1996,Sierra Leone,Africa,22634851,27030452,4395601
1996,Somalia,Africa,138079,4151487,4013408
1996,Sao Tome and Principe,Africa,199205,214374,15169
1996,Seychelles,Africa,52733426,104655850,51922424
1996,Chad,Africa,5204577,3096007,-2108570
1996,Togo,Africa,9044846,40916149,31871303
1996,Tunisia,Africa,84828344,268731067,183902723
1996,Tanzania,Africa,18949946,79863058,60913112
1996,Uganda,Africa,9132830,26839277,17706447
1996,South Africa,Africa,2705675475,3393825180,688149705
1996,Zambia,Africa,86840230,48572583,-38267647
1996,Zimbabwe,Africa,141071935,88235719,-52836216
1996,French South Antarctic Territory,Antarctica,513498,55462,-458036
1996,Afghanistan,Asia,15748294,16707267,958973
1996,United Arab Emirates,Asia,461711948,2471921877,2010209929
1996,Armenia,Asia,1482179,46843311,45361132
1996,Azerbaijan,Asia,3622737,65285810,61663073
1996,Bangladesh,Asia,1626184967,248853863,-1377331104
1996,Bahrain,Asia,111092465,194237606,83145141
1996,Brunei,Asia,47821474,314217429,266395955
1996,Bhutan,Asia,104103,379780,275677
1996,Cocos (Keeling) Islands,Asia,398468,202815,-195653
1996,China,Asia,41189462063,13071327957,-28118134106
1996,Christmas Island,Asia,249155,372116,122961
1996,Cyprus,Asia,17575367,539619332,522043965
1996,Georgia,Asia,8402496,84622747,76220251
1996,Hong Kong,Asia,10655735121,13954971943,3299236822
1996,Indonesia,Asia,7708561789,4500480750,-3208081039
1996,India,Asia,6581804926,3597670283,-2984134643
1996,British Indian Ocean Territory,Asia,46796,386037,339241
1996,Israel,Asia,6435695807,6227750425,-207945382
1996,Jordan,Asia,19153639,326842670,307689031
1996,Japan,Asia,1.11884E+11,70835495766,-41048052120
1996,Kazakhstan,Asia,107486571,129667048,22180477
1996,Kyrgyzstan,Asia,18129073,71131029,53001956
1996,Cambodia,Asia,4341700,17789484,13447784
1996,South Korea,Asia,21861764510,28880695310,7018930800
1996,Kuwait,Asia,1507232705,1927830756,420598051
1996,Laos,Asia,17365944,3302992,-14062952
1996,Lebanon,Asia,38370209,609899097,571528888
1996,Sri Lanka,Asia,1457876296,206006059,-1251870237
1996,Macau,Asia,823776154,113469449,-710306705
1996,Maldives,Asia,10618892,4287490,-6331402
1996,Burma,Asia,113649974,31526578,-82123396
1996,Mongolia,Asia,33737677,10896909,-22840768
1996,Malaysia,Asia,13903688324,9125375893,-4778312431
1996,Nepal,Asia,128135051,7652249,-120482802
1996,Oman,Asia,472961493,289970794,-182990699
1996,Pakistan,Asia,1323925849,1256019304,-67906545
1996,Philippines,Asia,7462055364,6205479341,-1256576023
1996,Qatar,Asia,90286516,200726988,110440472
1996,Saudi Arabia,Asia,8800458788,7254324473,-1546134315
1996,Singapore,Asia,20662308650,15973876622,-4688432028
1996,Syria,Asia,15173491,225605995,210432504
1996,Thailand,Asia,10803098889,8145785873,-2657313016
1996,Tajikistan,Asia,31466348,16387001,-15079347
1996,Turkmenistan,Asia,422459,200384463,199962004
1996,Turkey,Asia,1686647457,3276992951,1590345494
1996,Uzbekistan,Asia,151390516,346705340,195314824
1996,Vietnam,Asia,312333903,609679736,297345833
1996,Chinese Taipei,Asia,30163893636,18012352856,-12151540780
1996,Yemen,Asia,27202072,252996054,225793982
1996,Albania,Europe,10768321,24320382,13552061
1996,Andorra,Europe,2324246,59813304,57489058
1996,Austria,Europe,1939488040,2385642370,446154330
1996,Bulgaria,Europe,137161263,129203203,-7958060
1996,Bosnia and Herzegovina,Europe,9125711,52058472,42932761
1996,Belarus,Europe,55142435,40683165,-14459270
1996,Belgium-Luxembourg,Europe,7229254564,11874162783,4644908219
1996,Switzerland,Europe,7569776480,7864608973,294832493
1996,Czechia,Europe,521942670,666887266,144944596
1996,Germany,Europe,39780474280,24928696993,-14851777287
1996,Denmark,Europe,2073737077,1896887169,-176849908
1996,Spain,Europe,4417633318,6582391156,2164757838
1996,Estonia,Europe,78661710,112832960,34171250
1996,Finland,Europe,3266003586,2562029810,-703973776
1996,France,Europe,17499162800,17868055601,368892801
1996,United Kingdom,Europe,28972865957,32517421205,3544555248
1996,Gibraltar,Europe,2310263,10603504,8293241
1996,Greece,Europe,488445569,937166359,448720790
1996,Croatia,Europe,102704724,208147957,105443233
1996,Hungary,Europe,568452836,529601440,-38851396
1996,Ireland,Europe,4633500867,3939510908,-693989959
1996,Iceland,Europe,248554261,261691849,13137588
1996,Italy,Europe,18333649200,9486549785,-8847099415
1996,Lithuania,Europe,40567412,100685058,60117646
1996,Latvia,Europe,40180528,110210107,70029579
1996,Moldova,Europe,32419105,42067982,9648877
1996,North Macedonia,Europe,114704218,66481238,-48222980
1996,Malta,Europe,218710541,192011555,-26698986
1996,Netherlands,Europe,6394532449,15744875562,9350343113
1996,Norway,Europe,3744297805,1959839874,-1784457931
1996,Poland,Europe,666502687,1311322385,644819698
1996,Portugal,Europe,1095295015,1080421926,-14873089
1996,Romania,Europe,275608595,396158281,120549686
1996,Russia,Europe,4898220252,3501241903,-1396978349
1996,Slovakia,Europe,121403368,134616925,13213557
1996,Slovenia,Europe,294906270,266767006,-28139264
1996,Sweden,Europe,7042780597,3695959989,-3346820608
1996,Ukraine,Europe,444079802,522739187,78659385
1996,Yugoslavia,Europe,32680292,105045277,72364985
1996,Aruba,North America,522847454,209000261,-313847193
1996,Anguilla,North America,532597,10852033,10319436
1996,Netherlands Antilles,North America,549419623,492891876,-56527747
1996,Antigua and Barbuda,North America,7884436,69133677,61249241
1996,Bahamas,North America,158057466,645728968,487671502
1996,Belize,North America,100428679,137830834,37402155
1996,Bermuda,North America,2825117,237549286,234724169
1996,Barbados,North America,32340715,200603550,168262835
1996,Canada,North America,1.54223E+11,1.20139E+11,-34084166053
1996,Costa Rica,North America,1517620419,1795809837,278189418
1996,Cayman Islands,North America,14925583,151426448,136500865
1996,Dominica,North America,7348578,58351608,51003030
1996,Dominican Republic,North America,3359316486,3101153668,-258162818
1996,Grenada,North America,7061699,62804851,55743152
1996,Greenland,North America,3500916,18009630,14508714
1996,Guatemala,North America,949915722,1657879327,707963605
1996,Honduras,North America,1653183860,1481674360,-171509500
1996,Haiti,North America,164908138,433825049,268916911
1996,Jamaica,North America,651161838,1580365011,929203173
1996,Saint Kitts and Nevis,North America,17901432,70648963,52747531
1996,Saint Lucia,North America,28824863,122044487,93219624
1996,Mexico,North America,77616687682,58414266816,-19202420866
1996,Montserrat,North America,4616945,5946600,1329655
1996,Nicaragua,North America,448243758,376680405,-71563353
1996,Panama,North America,384397368,1407145454,1022748086
1996,El Salvador,North America,636267402,1227807818,591540416
1996,Saint Pierre and Miquelon,North America,468154,1606015,1137861
1996,Turks and Caicos Islands,North America,3837945,24684323,20846378
1996,Trinidad and Tobago,North America,1439183513,816812401,-622371112
1996,Saint Vincent and the Grenadines,North America,5421299,39354419,33933120
1996,British Virgin Islands,North America,3362314,46745641,43383327
1996,Australia,Oceania,3970750497,12889055884,8918305387
1996,Cook Islands,Oceania,964402,730972,-233430
1996,Fiji,Oceania,80544943,21981847,-58563096
1996,Micronesia,Oceania,12013055,21046063,9033008
1996,Kiribati,Oceania,967360,3963068,2995708
1996,Marshall Islands,Oceania,3269100,25042370,21773270
1996,New Caledonia,Oceania,62853468,23433200,-39420268
1996,Norfolk Island,Oceania,728491,898881,170390
1996,Niue,Oceania,345943,29600626,29254683
1996,Nauru,Oceania,97924,101266,3342
1996,New Zealand,Oceania,1411685067,2099498849,687813782
1996,Pitcairn Islands,Oceania,922642,31962,-890680
1996,Palau,Oceania,9548819,14480601,4931782
1996,Papua New Guinea,Oceania,79671861,65770350,-13901511
1996,French Polynesia,Oceania,24671800,135761520,111089720
1996,Solomon Islands,Oceania,2384672,6376384,3991712
1996,Tokelau,Oceania,2498190,254491,-2243699
1996,Tonga,Oceania,2634518,5022222,2387704
1996,Tuvalu,Oceania,3035,60257,57222
1996,Vanuatu,Oceania,559485,540872,-18613
1996,Samoa,Oceania,851048,10563417,9712369
1996,Argentina,South America,2038816793,4714491891,2675675098
1996,Bolivia,South America,353497867,399957331,46459464
1996,Brazil,South America,9729476733,12765037326,3035560593
1996,Chile,South America,2431771656,4520985116,2089213460
1996,Colombia,South America,4317903050,4896600794,578697744
1996,Ecuador,South America,1864849578,1397317454,-467532124
1996,Falkland Islands,South America,468468,96473,-371995
1996,Guyana,South America,115024175,126839926,11815751
1996,Peru,South America,1239574443,2119606864,880032421
1996,Paraguay,South America,55562278,628583361,573021083
1996,Suriname,South America,94411054,245865904,151454850
1996,Uruguay,South America,155895329,467092108,311196779
1996,Venezuela,South America,13920113507,4840671183,-9079442324
1997,Angola,Africa,2495605749,273848909,-2221756840
1997,Burundi,Africa,13847810,2436163,-11411647
1997,Benin,Africa,7966525,49756234,41789709
1997,Burkina Faso,Africa,4244444,33765097,29520653
1997,Central African Republic,Africa,1373334,4286739,2913405
1997,Cote d'Ivoire,Africa,322056019,208594770,-113461249
1997,Cameroon,Africa,62563943,170756358,108192415
1997,Democratic Republic of the Congo,Africa,269236188,36221979,-233014209
1997,Republic of the Congo,Africa,429934909,72654688,-357280221
1997,Comoros,Africa,2500290,329985,-2170305
1997,Cape Verde,Africa,868703,26660788,25792085
1997,Algeria,Africa,2279987243,830186096,-1449801147
1997,Egypt,Africa,671429313,3885563257,3214133944
1997,Eritrea,Africa,1278618,15691221,14412603
1997,Ethiopia,Africa,70814388,138611711,67797323
1997,Gabon,Africa,2234995349,152368258,-2082627091
1997,Ghana,Africa,169118065,374415110,205297045
1997,Guinea,Africa,119360180,89886031,-29474149
1997,Gambia,Africa,2580654,17291073,14710419
1997,Guinea-Bissau,Africa,100355,2443582,2343227
1997,Equatorial Guinea,Africa,27271396,46081781,18810385
1997,Kenya,Africa,83830990,266862274,183031284
1997,Liberia,Africa,4306871,35598456,31291585
1997,Morocco,Africa,300092965,519435847,219342882
1997,Madagascar,Africa,60016930,25149463,-34867467
1997,Mali,Africa,3444600,42043823,38599223
1997,Mozambique,Africa,29120632,44861530,15740898
1997,Mauritania,Africa,33273,20303475,20270202
1997,Mauritius,Africa,265731110,58783489,-206947621
1997,Malawi,Africa,80684675,11357141,-69327534
1997,Niger,Africa,43459026,31290025,-12169001
1997,Nigeria,Africa,6633766844,1038708004,-5595058840
1997,Rwanda,Africa,3752218,34117164,30364946
1997,Sudan,Africa,12478722,62017228,49538506
1997,Senegal,Africa,6144927,70429132,64284205
1997,Saint Helena,Africa,990026,2603553,1613527
1997,Sierra Leone,Africa,18437625,14786735,-3650890
1997,Somalia,Africa,333247,2723516,2390269
1997,Sao Tome and Principe,Africa,171890,12922167,12750277
1997,Seychelles,Africa,2510243,9405962,6895719
1997,Chad,Africa,2907421,2955241,47820
1997,Togo,Africa,9620904,41044124,31423220
1997,Tunisia,Africa,66670657,314592144,247921487
1997,Tanzania,Africa,29393544,74980806,45587262
1997,Uganda,Africa,19117808,41779821,22662013
1997,South Africa,Africa,2879066430,3290001495,410935065
1997,Zambia,Africa,56480366,26401884,-30078482
1997,Zimbabwe,Africa,146751993,78320768,-68431225
1997,Afghanistan,Asia,10143696,11269497,1125801
1997,United Arab Emirates,Asia,500489219,2545215522,2044726303
1997,Armenia,Asia,8799384,113526627,104727243
1997,Azerbaijan,Asia,5733230,62789202,57055972
1997,Bangladesh,Asia,2013834199,364496816,-1649337383
1997,Bahrain,Asia,116494988,356863632,240368644
1997,Brunei,Asia,77834855,201227028,123392173
1997,Bhutan,Asia,1031027,600093,-430934
1997,Cocos (Keeling) Islands,Asia,60672,352175,291503
1997,China,Asia,48305522785,13254770482,-35050752303
1997,Christmas Island,Asia,671022,349696,-321326
1997,Cyprus,Asia,23377375,556538850,533161475
1997,Georgia,Asia,7480131,149075766,141595635
1997,Hong Kong,Asia,11127417306,15111159738,3983742432
1997,Indonesia,Asia,8013185776,5226464944,-2786720832
1997,India,Asia,7214083018,3560586149,-3653496869
1997,British Indian Ocean Territory,Asia,11054781,449092,-10605689
1997,Iran,Asia,4707537,37562075,32854538
1997,Iraq,Asia,270391823,81949326,-188442497
1997,Israel,Asia,7449714137,5974167983,-1475546154
1997,Jordan,Asia,39940854,435206352,395265498
1997,Japan,Asia,1.15248E+11,68343923817,-46904494789
1997,Kazakhstan,Asia,113623116,253999576,140376460
1997,Kyrgyzstan,Asia,2371538,24827201,22455663
1997,Cambodia,Asia,109110118,16263589,-92846529
1997,South Korea,Asia,22406189134,26877778021,4471588887
1997,Kuwait,Asia,1690375755,1305149440,-385226315
1997,Laos,Asia,14464571,2644046,-11820525
1997,Lebanon,Asia,48452353,688128655,639676302
1997,Sri Lanka,Asia,1691386819,151009598,-1540377221
1997,Macau,Asia,989217092,108737008,-880480084
1997,Maldives,Asia,18041115,9214489,-8826626
1997,Burma,Asia,121378461,19402563,-101975898
1997,Mongolia,Asia,38360580,56916488,18555908
1997,Malaysia,Asia,15947075844,10673867888,-5273207956
1997,Nepal,Asia,124713273,25317573,-99395700
1997,Oman,Asia,330867025,444011100,113144075
1997,Pakistan,Asia,1499278665,1211642046,-287636619
1997,Philippines,Asia,8942579472,7331697810,-1610881662
1997,Qatar,Asia,139387973,349976411,210588438
1997,Saudi Arabia,Asia,8625444764,8024279237,-601165527
1997,Singapore,Asia,20338834850,17333632311,-3005202539
1997,Syria,Asia,26978087,179905350,152927263
1997,Thailand,Asia,12605761525,7860138823,-4745622702
1997,Tajikistan,Asia,8136269,18357256,10220987
1997,Turkmenistan,Asia,2088295,117405956,115317661
1997,Turkey,Asia,2105359053,4033432229,1928073176
1997,Uzbekistan,Asia,39645797,232741089,193095292
1997,Vietnam,Asia,384115965,272171769,-111944196
1997,Chinese Taipei,Asia,29741327937,20204307529,-9537020408
1997,Yemen,Asia,16046840,151528180,135481340
1997,Albania,Europe,12976561,4005072,-8971489
1997,Andorra,Europe,289890,60154909,59865019
1997,Austria,Europe,2296701515,2487173105,190471590
1997,Bulgaria,Europe,173187303,177812708,4625405
1997,Bosnia and Herzegovina,Europe,8323428,96416323,88092895
1997,Belarus,Europe,69153337,34189602,-34963735
1997,Belgium-Luxembourg,Europe,8412808489,13161119321,4748310832
1997,Switzerland,Europe,8161327632,8820468375,659140743
1997,Czechia,Europe,607234733,727411344,120176611
1997,Germany,Europe,43949622074,26775721625,-17173900449
1997,Denmark,Europe,2082613138,1783880978,-298732160
1997,Spain,Europe,4712745187,6422134169,1709388982
1997,Estonia,Europe,97600301,136164945,38564644
1997,Finland,Europe,2894034880,2039007448,-855027432
1997,France,Europe,18383278410,18729492483,346214073
1997,United Kingdom,Europe,33138355964,37587219355,4448863391
1997,Gibraltar,Europe,613510,7617406,7003896
1997,Greece,Europe,519663831,990306752,470642921
1997,Croatia,Europe,109091114,270815209,161724095
1997,Hungary,Europe,806500318,685244732,-121255586
1997,Ireland,Europe,6121608410,4804331691,-1317276719
1997,Iceland,Europe,275628707,191971307,-83657400
1997,Italy,Europe,18791782870,9797042241,-8994740629
1997,Lithuania,Europe,94485663,131157093,36671430
1997,Latvia,Europe,76788077,201006051,124217974
1997,Moldova,Europe,50366612,12955833,-37410779
1997,North Macedonia,Europe,162667492,96399585,-66267907
1997,Malta,Europe,208266324,185775042,-22491282
1997,Netherlands,Europe,7148473582,18650293993,11501820411
1997,Norway,Europe,3325442815,2055016885,-1270425930
1997,Poland,Europe,786932237,1523458849,736526612
1997,Portugal,Europe,1129041009,1060321112,-68719897
1997,Romania,Europe,387312537,401106386,13793849
1997,Russia,Europe,4590858252,3561086700,-1029771552
1997,Slovakia,Europe,182230250,198638966,16408716
1997,Slovenia,Europe,287274544,224871117,-62403427
1997,Sweden,Europe,6977054938,3768715153,-3208339785
1997,Ukraine,Europe,467936044,593594754,125658710
1997,Yugoslavia,Europe,17394327,108644296,91249969
1997,Aruba,North America,568954428,223388651,-345565777
1997,Anguilla,North America,362596,15689846,15327250
1997,Netherlands Antilles,North America,466202687,446851980,-19350707
1997,Antigua and Barbuda,North America,3102190,73710999,70608809
1997,Bahamas,North America,223696103,887003937,663307834
1997,Belize,North America,123160763,153394498,30233735
1997,Bermuda,North America,3335537,415095204,411759667
1997,Barbados,North America,55785139,402958456,347173317
1997,Canada,North America,1.67058E+11,1.37737E+11,-29320650478
1997,Costa Rica,North America,2226359013,2237547406,11188393
1997,Cayman Islands,North America,16643501,194109871,177466370
1997,Dominica,North America,7671448,62282682,54611234
1997,Dominican Republic,North America,3918073519,3821467365,-96606154
1997,Grenada,North America,10848893,61887722,51038829
1997,Greenland,North America,8550945,11925914,3374969
1997,Guatemala,North America,1022254537,1804764429,782509892
1997,Honduras,North America,2099792317,1791179090,-308613227
1997,Haiti,North America,218037440,462746532,244709092
1997,Jamaica,North America,674473878,1502513038,828039160
1997,Saint Kitts and Nevis,North America,35528626,70366121,34837495
1997,Saint Lucia,North America,36119683,138579771,102460088
1997,Mexico,North America,90161888383,72535391510,-17626496873
1997,Montserrat,North America,4997917,12998321,8000404
1997,Nicaragua,North America,487746714,474270643,-13476071
1997,Panama,North America,400530989,1527523093,1126992104
1997,El Salvador,North America,1358896511,1447837151,88940640
1997,Saint Pierre and Miquelon,North America,2043873,1694099,-349774
1997,Turks and Caicos Islands,North America,4348759,33529600,29180841
1997,Trinidad and Tobago,North America,1296152510,1670631108,374478598
1997,Saint Vincent and the Grenadines,North America,4541480,80902388,76360908
1997,British Virgin Islands,North America,11665279,56556051,44890772
1997,Australia,Oceania,4781187572,12549043201,7767855629
1997,Cook Islands,Oceania,1173207,1206691,33484
1997,Fiji,Oceania,90263379,26568371,-63695008
1997,Micronesia,Oceania,12333048,23097574,10764526
1997,Kiribati,Oceania,916414,3860375,2943961
1997,Marshall Islands,Oceania,2961685,21619335,18657650
1997,New Caledonia,Oceania,60691708,27893498,-32798210
1997,Norfolk Island,Oceania,55933,3318443,3262510
1997,Niue,Oceania,54812,35327590,35272778
1997,Nauru,Oceania,108878,915557,806679
1997,New Zealand,Oceania,1524835603,2256185383,731349780
1997,Palau,Oceania,13715990,12817817,-898173
1997,Papua New Guinea,Oceania,60443598,108729505,48285907
1997,French Polynesia,Oceania,35505070,151857898,116352828
1997,Solomon Islands,Oceania,1174610,1328002,153392
1997,Tokelau,Oceania,1975692,325884,-1649808
1997,Tonga,Oceania,2089110,6043042,3953932
1997,Vanuatu,Oceania,2116448,291986,-1824462
1997,Samoa,Oceania,2663368,9268109,6604741
1997,Argentina,South America,2306714301,6035899412,3729185111
1997,Bolivia,South America,281854858,423973304,142118446
1997,Brazil,South America,9952891735,15776311204,5823419469
1997,Chile,South America,2522569521,4608912808,2086343287
1997,Colombia,South America,4467286541,5628811977,1161525436
1997,Ecuador,South America,2078228785,1661401081,-416827704
1997,Falkland Islands,South America,538939,101785,-437154
1997,Guyana,South America,193930140,211736949,17806809
1997,Peru,South America,1643392789,2355767446,712374657
1997,Paraguay,South America,78460904,747606294,669145390
1997,Suriname,South America,84738287,168904800,84166513
1997,Uruguay,South America,176901785,501856853,324955068
1997,Venezuela,South America,13170110119,6200006982,-6970103137
1998,Angola,Africa,2078351735,347643466,-1730708269
1998,Burundi,Africa,7801548,6060169,-1741379
1998,Benin,Africa,4072137,63974559,59902422
1998,Burkina Faso,Africa,1049907,31734275,30684368
1998,Central African Republic,Africa,2590322,6971915,4381593
1998,Cote d'Ivoire,Africa,423217013,185642616,-237574397
1998,Cameroon,Africa,52211770,121336291,69124521
1998,Democratic Republic of the Congo,Africa,168196622,32806639,-135389983
1998,Republic of the Congo,Africa,288157989,89198228,-198959761
1998,Comoros,Africa,775943,598650,-177293
1998,Cape Verde,Africa,403161,14754121,14350960
1998,Djibouti,Africa,460903,19233553,18772650
1998,Algeria,Africa,1549009974,823070799,-725939175
1998,Egypt,Africa,781108018,3211602102,2430494084
1998,Eritrea,Africa,708087,24023763,23315676
1998,Ethiopia,Africa,50857932,122379884,71521952
1998,Gabon,Africa,1270630844,165953479,-1104677365
1998,Ghana,Africa,153022894,310727008,157704114
1998,Guinea,Africa,140422460,71390995,-69031465
1998,Gambia,Africa,2077829,20317217,18239388
1998,Guinea-Bissau,Africa,177450,907004,729554
1998,Equatorial Guinea,Africa,62004260,85581180,23576920
1998,Kenya,Africa,103409641,265272978,161863337
1998,Liberia,Africa,24222560,38434724,14212164
1998,Morocco,Africa,350152370,705908214,355755844
1998,Madagascar,Africa,61607061,23321061,-38286000
1998,Mali,Africa,3362684,42410436,39047752
1998,Mozambique,Africa,24906110,44892619,19986509
1998,Mauritania,Africa,332886,19361701,19028815
1998,Mauritius,Africa,299673278,57963943,-241709335
1998,Malawi,Africa,72177891,11163299,-61014592
1998,Niger,Africa,1618155,32673303,31055148
1998,Nigeria,Africa,4517420986,919917383,-3597503603
1998,Rwanda,Africa,3749034,24590957,20841923
1998,Sudan,Africa,3172827,6738901,3566074
1998,Senegal,Africa,7292050,81118415,73826365
1998,Saint Helena,Africa,216650,130208,-86442
1998,Sierra Leone,Africa,12178773,22093172,9914399
1998,Somalia,Africa,545131,2649731,2104600
1998,Sao Tome and Principe,Africa,111536,9348963,9237427
1998,Seychelles,Africa,938658,15047588,14108930
1998,Chad,Africa,7334242,3199198,-4135044
1998,Togo,Africa,2958656,33945186,30986530
1998,Tunisia,Africa,63273595,260622262,197348667
1998,Tanzania,Africa,36618630,93545535,56926905
1998,Uganda,Africa,23322938,42372936,19049998
1998,South Africa,Africa,3235411219,3641630717,406219498
1998,Zambia,Africa,66708438,30669182,-36039256
1998,Zimbabwe,Africa,132728099,90779643,-41948456
1998,French South Antarctic Territory,Antarctica,1097543,714821,-382722
1998,Afghanistan,Asia,14658980,6802942,-7856038
1998,United Arab Emirates,Asia,581111605,2299940123,1718828518
1998,Armenia,Asia,11726664,32664474,20937810
1998,Azerbaijan,Asia,17802600,126757996,108955396
1998,Bangladesh,Asia,2115390119,380154912,-1735235207
1998,Bahrain,Asia,151426352,232039741,80613389
1998,Brunei,Asia,203476055,235365181,31889126
1998,Bhutan,Asia,1207383,3365749,2158366
1998,Cocos (Keeling) Islands,Asia,167322,314953,147631
1998,China,Asia,54119818556,14513547742,-39606270814
1998,Christmas Island,Asia,268313,449796,181483
1998,Cyprus,Asia,33158054,374280100,341122046
1998,Georgia,Asia,14052013,154698255,140646242
1998,Hong Kong,Asia,12323284596,12754240468,430955872
1998,Indonesia,Asia,8146931949,2917147780,-5229784169
1998,India,Asia,7886512215,3615179297,-4271332918
1998,British Indian Ocean Territory,Asia,290385,617856,327471
1998,Iran,Asia,3565054,59910857,56345803
1998,Iraq,Asia,1157484814,100372458,-1057112356
1998,Israel,Asia,8509230663,6457399619,-2051831044
1998,Jordan,Asia,16026453,420670726,404644273
1998,Japan,Asia,1.15506E+11,60070651102,-55434992815
1998,Kazakhstan,Asia,151937108,224876510,72939402
1998,Kyrgyzstan,Asia,285605,16989403,16703798
1998,Cambodia,Asia,386968142,9279600,-377688542
1998,South Korea,Asia,23493985467,18245349760,-5248635707
1998,Kuwait,Asia,1238143625,1436506052,198362427
1998,Laos,Asia,21984874,3555204,-18429670
1998,Lebanon,Asia,52228505,641645144,589416639
1998,Sri Lanka,Asia,1833143433,184531518,-1648611915
1998,Macau,Asia,1057679545,68365863,-989313682
1998,Maldives,Asia,22229694,6451965,-15777729
1998,Burma,Asia,172569546,31004545,-141565001
1998,Mongolia,Asia,50170450,42473480,-7696970
1998,Malaysia,Asia,16555616465,9202051017,-7353565448
1998,Nepal,Asia,167847685,20781512,-147066173
1998,Oman,Asia,296028957,395030962,99002005
1998,Pakistan,Asia,1751112211,709277843,-1041834368
1998,Philippines,Asia,8801221194,6582616576,-2218604618
1998,Qatar,Asia,187892862,339228960,151336098
1998,Saudi Arabia,Asia,6198814378,10144333457,3945519079
1998,Singapore,Asia,18970480411,15989205978,-2981274433
1998,Syria,Asia,45392739,160092954,114700215
1998,Thailand,Asia,14128475943,5452871369,-8675604574
1998,Tajikistan,Asia,30287591,10936793,-19350798
1998,Turkmenistan,Asia,2867196,24112062,21244866
1998,Turkey,Asia,2330138502,3921341063,1591202561
1998,Uzbekistan,Asia,34025125,145035416,111010291
1998,Vietnam,Asia,549061823,268558669,-280503154
1998,Chinese Taipei,Asia,32357609934,18344574804,-14013035130
1998,Yemen,Asia,32180599,176038052,143857453
1998,Albania,Europe,13617067,19971667,6354600
1998,Andorra,Europe,193089,33735404,33542315
1998,Austria,Europe,2631211205,2822585306,191374101
1998,Bulgaria,Europe,173562017,203584466,30022449
1998,Bosnia and Herzegovina,Europe,6960850,37074262,30113412
1998,Belarus,Europe,130976753,112169486,-18807267
1998,Belgium-Luxembourg,Europe,8706914451,14025449204,5318534753
1998,Switzerland,Europe,8621255322,7102260528,-1518994794
1998,Czechia,Europe,685910575,878767215,192856640
1998,Germany,Europe,50724089868,29127770443,-21596319425
1998,Denmark,Europe,2312171717,1998984743,-313186974
1998,Spain,Europe,4739764516,6617734259,1877969743
1998,Estonia,Europe,122692709,199790008,77097299
1998,Finland,Europe,3248391676,2218365789,-1030025887
1998,France,Europe,22504228518,20499258330,-2004970188
1998,United Kingdom,Europe,34655645849,40353141890,5697496041
1998,Gibraltar,Europe,733994,7491014,6757020
1998,Greece,Europe,579710123,1494181336,914471213
1998,Croatia,Europe,104653266,265123651,160470385
1998,Hungary,Europe,1227112696,795857003,-431255693
1998,Ireland,Europe,8654285956,5867422520,-2786863436
1998,Iceland,Europe,271695874,259344895,-12350979
1998,Italy,Europe,20529595628,10099114737,-10430480891
1998,Lithuania,Europe,123695013,128449753,4754740
1998,Latvia,Europe,92588651,188923732,96335081
1998,Moldova,Europe,103514120,39976029,-63538091
1998,North Macedonia,Europe,207393781,72373257,-135020524
1998,Malta,Europe,275882996,314831714,38948718
1998,Netherlands,Europe,7219373758,18143254413,10923880655
1998,Norway,Europe,2716456136,2413538831,-302917305
1998,Poland,Europe,886734176,1295334769,408600593
1998,Portugal,Europe,1268353955,976617714,-291736241
1998,Romania,Europe,388306836,471903423,83596587
1998,Russia,Europe,5488357644,3886165890,-1602191754
1998,Slovakia,Europe,161268350,223226099,61957749
1998,Slovenia,Europe,297277925,241215032,-56062893
1998,Sweden,Europe,7438465434,4094934790,-3343530644
1998,Ukraine,Europe,580182273,507093672,-73088601
1998,Yugoslavia,Europe,24721661,133107070,108385409
1998,Aruba,North America,426821436,331983000,-94838436
1998,Anguilla,North America,1699126,14132711,12433585
1998,Netherlands Antilles,North America,410142960,851050102,440907142
1998,Antigua and Barbuda,North America,1282201,79087670,77805469
1998,Bahamas,North America,262357714,842678993,580321279
1998,Belize,North America,79864663,151905490,72040827
1998,Bermuda,North America,3600168,341288346,337688178
1998,Barbados,North America,54657262,372303077,317645815
1998,Canada,North America,1.70115E+11,1.42799E+11,-27316004056
1998,Costa Rica,North America,2682652495,3067838433,385185938
1998,Cayman Islands,North America,11156093,322246313,311090220
1998,Dominica,North America,3916751,47716234,43799483
1998,Dominican Republic,North America,4400469954,3863850678,-536619276
1998,Grenada,North America,23890338,80455145,56564807
1998,Greenland,North America,7571411,12963402,5391991
1998,Guatemala,North America,1063703924,2144389925,1080686001
1998,Honduras,North America,2099281634,1787747179,-311534455
1998,Haiti,North America,276383937,499074560,222690623
1998,Jamaica,North America,689106344,1471229362,782123018
1998,Saint Kitts and Nevis,North America,30184724,39043758,8859034
1998,Saint Lucia,North America,28881786,130948087,102066301
1998,Mexico,North America,98301860447,80878099440,-17423761007
1998,Montserrat,North America,207765,4105623,3897858
1998,Nicaragua,North America,447999987,443639318,-4360669
1998,Panama,North America,353303182,1722193659,1368890477
1998,El Salvador,North America,562285854,1473766226,911480372
1998,Saint Pierre and Miquelon,North America,4804593,2806298,-1998295
1998,Turks and Caicos Islands,North America,4486444,36858653,32372209
1998,Trinidad and Tobago,North America,1041518174,1237632860,196114686
1998,Saint Vincent and the Grenadines,North America,6150719,195582261,189431542
1998,British Virgin Islands,North America,5215262,55433247,50217985
1998,Australia,Oceania,5421686119,12184453478,6762767359
1998,Cook Islands,Oceania,637413,936111,298698
1998,Fiji,Oceania,104162563,67537067,-36625496
1998,Micronesia,Oceania,13317260,25129507,11812247
1998,Kiribati,Oceania,1024010,2886578,1862568
1998,Marshall Islands,Oceania,1993577,20135751,18142174
1998,New Caledonia,Oceania,19197044,15157706,-4039338
1998,Norfolk Island,Oceania,84822,2124397,2039575
1998,Niue,Oceania,81593,5016920,4935327
1998,Nauru,Oceania,100042,764846,664804
1998,New Zealand,Oceania,1628751897,2001622055,372870158
1998,Palau,Oceania,14196227,11804132,-2392095
1998,Papua New Guinea,Oceania,159310767,134669772,-24640995
1998,French Polynesia,Oceania,32335231,139150310,106815079
1998,Solomon Islands,Oceania,2298938,1536999,-761939
1998,Tokelau,Oceania,3023278,4716888,1693610
1998,Tonga,Oceania,4060934,9197736,5136802
1998,Tuvalu,Oceania,2076,64906,62830
1998,Vanuatu,Oceania,4837117,38633488,33796371
1998,Samoa,Oceania,6588161,8601438,2013277
1998,Argentina,South America,2335954798,6229327278,3893372480
1998,Bolivia,South America,314588714,557798110,243209396
1998,Brazil,South America,10378424255,14671168428,4292744173
1998,Chile,South America,2445030322,4309206633,1864176311
1998,Colombia,South America,4315713659,4739377279,423663620
1998,Ecuador,South America,1694666422,1854619622,159953200
1998,Falkland Islands,South America,154355,3022615,2868260
1998,Guyana,South America,204103686,209704084,5600398
1998,Peru,South America,1879221700,2302763545,423541845
1998,Paraguay,South America,96564140,534254418,437690278
1998,Suriname,South America,98910908,171433935,72523027
1998,Uruguay,South America,240756068,525023508,284267440
1998,Venezuela,South America,9231986874,6247718292,-2984268582
1999,Angola,Africa,2183435055,247522365,-1935912690
1999,Burundi,Africa,6484353,3655721,-2828632
1999,Benin,Africa,17530215,50630615,33100400
1999,Burkina Faso,Africa,3535254,26732917,23197663
1999,Central African Republic,Africa,2599673,4130786,1531113
1999,Cote d'Ivoire,Africa,388762894,162056366,-226706528
1999,Cameroon,Africa,74053813,62202331,-11851482
1999,Democratic Republic of the Congo,Africa,219527599,20261246,-199266353
1999,Republic of the Congo,Africa,377316950,43434624,-333882326
1999,Comoros,Africa,1748751,279589,-1469162
1999,Cape Verde,Africa,1063462,14061735,12998273
1999,Djibouti,Africa,109094,26013148,25904054
1999,Algeria,Africa,1827024685,642221554,-1184803131
1999,Egypt,Africa,655899136,3712624225,3056725089
1999,Eritrea,Africa,472781,3427258,2954477
1999,Ethiopia,Africa,29521417,213067382,183545965
1999,Gabon,Africa,1570217712,103101535,-1467116177
1999,Ghana,Africa,220474465,278834878,58360413
1999,Guinea,Africa,138641102,55933416,-82707686
1999,Gambia,Africa,372143,14682407,14310264
1999,Guinea-Bissau,Africa,73154,800732,727578
1999,Equatorial Guinea,Africa,38763567,216480795,177717228
1999,Kenya,Africa,77669739,218689104,141019365
1999,Liberia,Africa,29279095,38613736,9334641
1999,Morocco,Africa,425105608,793300792,368195184
1999,Madagascar,Africa,78012281,115455564,37443283
1999,Mali,Africa,8690765,48957319,40266554
1999,Mozambique,Africa,9572380,32784656,23212276
1999,Mauritania,Africa,754591,24630775,23876184
1999,Mauritius,Africa,285564509,86782286,-198782223
1999,Malawi,Africa,75221948,14437700,-60784248
1999,Niger,Africa,11028598,26320987,15292389
1999,Nigeria,Africa,4042778454,719237788,-3323540666
1999,Rwanda,Africa,3460231,45927791,42467560
1999,Sudan,Africa,58978,17073696,17014718
1999,Senegal,Africa,6060761,84307650,78246889
1999,Saint Helena,Africa,154975,358365,203390
1999,Sierra Leone,Africa,10585773,10018725,-567048
1999,Somalia,Africa,171028,2782144,2611116
1999,Sao Tome and Principe,Africa,2593992,760146,-1833846
1999,Seychelles,Africa,4931398,10890365,5958967
1999,Chad,Africa,6895630,2551692,-4343938
1999,Togo,Africa,4634587,30020896,25386309
1999,Tunisia,Africa,76384456,348523490,272139034
1999,Tanzania,Africa,38427652,96205697,57778045
1999,Uganda,Africa,17263616,43861478,26597862
1999,South Africa,Africa,3464369826,3104175962,-360193864
1999,Zambia,Africa,37095272,16877085,-20218187
1999,Zimbabwe,Africa,138878935,58202754,-80676181
1999,Afghanistan,Asia,9322178,17562300,8240122
1999,United Arab Emirates,Asia,588830093,2645052821,2056222728
1999,Armenia,Asia,24450366,96201695,71751329
1999,Azerbaijan,Asia,37725366,92248410,54523044
1999,Bangladesh,Asia,2041688124,271056889,-1770631235
1999,Bahrain,Asia,213970167,283096329,69126162
1999,Brunei,Asia,365520690,60299947,-305220743
1999,Bhutan,Asia,882124,1146447,264323
1999,Cocos (Keeling) Islands,Asia,236292,468774,232482
1999,China,Asia,63383905358,13614666551,-49769238807
1999,Christmas Island,Asia,89732,1425528,1335796
1999,Cyprus,Asia,42499800,334105667,291605867
1999,Georgia,Asia,19618373,95457710,75839337
1999,Hong Kong,Asia,12037994871,12191871011,153876140
1999,Indonesia,Asia,8808065477,2406587809,-6401477668
1999,India,Asia,8899716740,4122940984,-4776775756
1999,British Indian Ocean Territory,Asia,133741,843083,709342
1999,Iran,Asia,7469905,106552794,99082889
1999,Iraq,Asia,3834724481,9540786,-3825183695
1999,Israel,Asia,9614722805,7139853789,-2474869016
1999,Jordan,Asia,47102378,356754381,309652003
1999,Japan,Asia,1.25874E+11,59715122894,-66158702761
1999,Kazakhstan,Asia,216256474,175084422,-41172052
1999,Kyrgyzstan,Asia,530502,11703818,11173316
1999,Cambodia,Asia,633833697,14909234,-618924463
1999,South Korea,Asia,30691682774,23392244990,-7299437784
1999,Kuwait,Asia,1322330789,862755646,-459575143
1999,Laos,Asia,13178498,1464139,-11714359
1999,Lebanon,Asia,48212921,476622426,428409505
1999,Sri Lanka,Asia,1886022906,267418428,-1618604478
1999,Macau,Asia,1064706581,73327447,-991379134
1999,Maldives,Asia,49904754,11970107,-37934647
1999,Burma,Asia,248079996,8452224,-239627772
1999,Mongolia,Asia,64024365,30615809,-33408556
1999,Malaysia,Asia,19872611972,9226113646,-10646498326
1999,Nepal,Asia,166432783,27210394,-139222389
1999,Oman,Asia,305947232,278568885,-27378347
1999,Pakistan,Asia,1834220476,416231101,-1417989375
1999,Philippines,Asia,9860132428,7118339523,-2741792905
1999,North Korea,Asia,28926,8174842,8145916
1999,Qatar,Asia,238186516,139569038,-98617478
1999,Saudi Arabia,Asia,8268687853,7556618299,-712069554
1999,Singapore,Asia,19308740199,16415850886,-2892889313
1999,Syria,Asia,93160985,170859267,77698282
1999,Thailand,Asia,13926282350,5726971440,-8199310910
1999,Tajikistan,Asia,21349646,10348201,-11001445
1999,Turkmenistan,Asia,9296326,69351673,60055347
1999,Turkey,Asia,2660946007,3223133583,562187576
1999,Uzbekistan,Asia,23725908,320331984,296606076
1999,Vietnam,Asia,610266042,283082684,-327183358
1999,Chinese Taipei,Asia,34039127372,19286166683,-14752960689
1999,Yemen,Asia,16633618,155961873,139328255
1999,Albania,Europe,9611930,35376768,25764838
1999,Andorra,Europe,348887,25197477,24848590
1999,Austria,Europe,2928528251,2906354132,-22174119
1999,Belgium,Europe,9184738867,11975083952,2790345085
1999,Bulgaria,Europe,190257404,171840081,-18417323
1999,Bosnia and Herzegovina,Europe,11409791,41832183,30422392
1999,Belarus,Europe,107571754,113897151,6325397
1999,Switzerland,Europe,9854818721,8066931478,-1787887243
1999,Czechia,Europe,718791812,916249356,197457544
1999,Germany,Europe,54517128435,29830841817,-24686286618
1999,Denmark,Europe,2725417303,1836021640,-889395663
1999,Spain,Europe,5022576939,6794036977,1771460038
1999,Estonia,Europe,149671929,183400189,33728260
1999,Finland,Europe,3209498501,2014003637,-1195494864
1999,France,Europe,23138858133,21004674142,-2134183991
1999,United Kingdom,Europe,37925613544,39215973255,1290359711
1999,Gibraltar,Europe,642869,3097081,2454212
1999,Greece,Europe,675348574,1383024979,707676405
1999,Croatia,Europe,142487904,259492300,117004396
1999,Hungary,Europe,1566084502,779502450,-786582052
1999,Ireland,Europe,10842342201,6456293707,-4386048494
1999,Iceland,Europe,314867515,280019863,-34847652
1999,Italy,Europe,21749709163,10346671146,-11403038017
1999,Lithuania,Europe,144167396,119820059,-24347337
1999,Luxembourg,Europe,294544994,1200508653,905963659
1999,Latvia,Europe,140799276,143993023,3193747
1999,Moldova,Europe,83407396,24575708,-58831688
1999,North Macedonia,Europe,165157595,59668535,-105489060
1999,Malta,Europe,448146397,245074382,-203072015
1999,Netherlands,Europe,8252313007,18635607636,10383294629
1999,Norway,Europe,3721132281,2330287973,-1390844308
1999,Poland,Europe,849618371,1208294541,358676170
1999,Portugal,Europe,1315819964,1079568505,-236251459
1999,Romania,Europe,418529013,316185554,-102343459
1999,Russia,Europe,5069223700,2209123719,-2860099981
1999,Slovakia,Europe,178609587,204475691,25866104
1999,Slovenia,Europe,296037070,241690650,-54346420
1999,Sweden,Europe,6262198435,4113063658,-2149134777
1999,Ukraine,Europe,558898177,399911892,-158986285
1999,Yugoslavia,Europe,6620976,93400632,86779656
1999,Aruba,North America,603748061,286310630,-317437431
1999,Anguilla,North America,1643849,18886445,17242596
1999,Netherlands Antilles,North America,273943501,563163100,289219599
1999,Antigua and Barbuda,North America,3768912,147385655,143616743
1999,Bahamas,North America,337536325,885414170,547877845
1999,Belize,North America,77123790,124950932,47827142
1999,Bermuda,North America,3226513,287395405,284168892
1999,Barbados,North America,66230663,393718098,327487435
1999,Canada,North America,1.92513E+11,1.51716E+11,-40796624130
1999,Costa Rica,North America,3560029724,2586595930,-973433794
1999,Cuba,North America,652070,7276107,6624037
1999,Cayman Islands,North America,6863174,260903706,254040532
1999,Dominica,North America,17065633,58042550,40976917
1999,Dominican Republic,North America,4245231824,3959829034,-285402790
1999,Grenada,North America,21634876,86836147,65201271
1999,Greenland,North America,6541056,10735965,4194909
1999,Guatemala,North America,1131413662,2043654315,912240653
1999,Honduras,North America,1919299511,1918808832,-490679
1999,Haiti,North America,303432485,551610534,248178049
1999,Jamaica,North America,613062882,1336453234,723390352
1999,Saint Kitts and Nevis,North America,32385207,79656877,47271670
1999,Saint Lucia,North America,23964817,146482621,122517804
1999,Mexico,North America,1.14106E+11,89524483408,-24581930359
1999,Montserrat,North America,637166,13493467,12856301
1999,Nicaragua,North America,466600316,504461382,37861066
1999,Panama,North America,366204095,1707630239,1341426144
1999,El Salvador,North America,742958708,1475867224,732908516
1999,Saint Pierre and Miquelon,North America,4813015,2651273,-2161742
1999,Turks and Caicos Islands,North America,11062812,110968467,99905655
1999,Trinidad and Tobago,North America,1300245246,967695748,-332549498
1999,Saint Vincent and the Grenadines,North America,8687596,102887039,94199443
1999,British Virgin Islands,North America,18274137,51867756,33593619
1999,Australia,Oceania,4959826153,12220775379,7260949226
1999,Cook Islands,Oceania,577193,918868,341675
1999,Fiji,Oceania,105689157,120541622,14852465
1999,Micronesia,Oceania,10642546,21094341,10451795
1999,Kiribati,Oceania,1146205,5682603,4536398
1999,Marshall Islands,Oceania,2350947,30769080,28418133
1999,New Caledonia,Oceania,21262096,72210975,50948879
1999,Norfolk Island,Oceania,382135,2245703,1863568
1999,Niue,Oceania,63385,127821,64436
1999,Nauru,Oceania,93919,850363,756444
1999,New Zealand,Oceania,1783664402,2165835641,382171239
1999,Pitcairn Islands,Oceania,4118,221380,217262
1999,Palau,Oceania,16726279,12269343,-4456936
1999,Papua New Guinea,Oceania,133946599,34157376,-99789223
1999,French Polynesia,Oceania,29524886,153707863,124182977
1999,Solomon Islands,Oceania,1097777,883474,-214303
1999,Tokelau,Oceania,5775281,5274454,-500827
1999,Tonga,Oceania,3301943,4818913,1516970
1999,Vanuatu,Oceania,2145975,6944514,4798539
1999,Wallis and Futuna,Oceania,32925,153128,120203
1999,Samoa,Oceania,5012037,10571763,5559726
1999,Argentina,South America,2730308102,5005338459,2275030357
1999,Bolivia,South America,473895438,414785839,-59109599
1999,Brazil,South America,11272372746,13107414869,1835042123
1999,Chile,South America,2954914992,3037949985,83034993
1999,Colombia,South America,6055594122,3896066076,-2159528046
1999,Ecuador,South America,1797761025,1049187620,-748573405
1999,Falkland Islands,South America,1498647,83349,-1415298
1999,Guyana,South America,150392191,200399795,50007604
1999,Peru,South America,1794405166,2008385350,213980184
1999,Paraguay,South America,75308228,384079804,308771576
1999,Suriname,South America,122945207,181323251,58378044
1999,Uruguay,South America,178365674,433765250,255399576
1999,Venezuela,South America,11260281215,5612346982,-5647934233
2000,Angola,Africa,3081954860,219188002,-2862766858
2000,Burundi,Africa,7886316,4688750,-3197566
2000,Benin,Africa,3074810,29834198,26759388
2000,Burkina Faso,Africa,2776026,28707213,25931187
2000,Botswana,Africa,18728403,38847083,20118680
2000,Central African Republic,Africa,2630330,2070710,-559620
2000,Cote d'Ivoire,Africa,330953735,128320478,-202633257
2000,Cameroon,Africa,104266412,88488047,-15778365
2000,Democratic Republic of the Congo,Africa,191730102,9606492,-182123610
2000,Republic of the Congo,Africa,467053172,79037764,-388015408
2000,Comoros,Africa,3489538,772665,-2716873
2000,Cape Verde,Africa,5299089,13824971,8525882
2000,Djibouti,Africa,107518,12185334,12077816
2000,Algeria,Africa,3396429311,1058013305,-2338416006
2000,Egypt,Africa,902669676,3681751391,2779081715
2000,Eritrea,Africa,194094,14162590,13968496
2000,Ethiopia,Africa,26473097,173375700,146902603
2000,Gabon,Africa,2101670011,130374240,-1971295771
2000,Ghana,Africa,203321680,224840880,21519200
2000,Guinea,Africa,86692003,85256942,-1435061
2000,Gambia,Africa,511496,13337378,12825882
2000,Guinea-Bissau,Africa,37842,285569,247727
2000,Equatorial Guinea,Africa,134540353,93535776,-41004577
2000,Kenya,Africa,63564763,265272816,201708053
2000,Liberia,Africa,42058224,36509709,-5548515
2000,Lesotho,Africa,329622760,1141574,-328481186
2000,Morocco,Africa,432294383,651376323,219081940
2000,Madagascar,Africa,174046456,53485400,-120561056
2000,Mali,Africa,10270200,32409410,22139210
2000,Mozambique,Africa,25492723,63810526,38317803
2000,Mauritania,Africa,132886,28073383,27940497
2000,Mauritius,Africa,319046570,59519954,-259526616
2000,Malawi,Africa,62521245,13668669,-48852576
2000,Namibia,Africa,65140245,79915188,14774943
2000,Niger,Africa,24848820,44596776,19747956
2000,Nigeria,Africa,9268559885,855784200,-8412775685
2000,Rwanda,Africa,4838491,18496663,13658172
2000,Sudan,Africa,1740236,43370596,41630360
2000,Senegal,Africa,5959981,107400603,101440622
2000,Saint Helena,Africa,3248402,375129,-2873273
2000,Sierra Leone,Africa,3837503,21149271,17311768
2000,Somalia,Africa,441768,4666946,4225178
2000,Sao Tome and Principe,Africa,451999,1129111,677112
2000,Eswatini,Africa,110189780,68579502,-41610278
2000,Seychelles,Africa,5474900,10939035,5464135
2000,Chad,Africa,4327168,10476140,6148972
2000,Togo,Africa,4686857,13113684,8426827
2000,Tunisia,Africa,85916660,368652706,282736046
2000,Tanzania,Africa,32702876,69691812,36988936
2000,Uganda,Africa,16377285,36619776,20242491
2000,South Africa,Africa,4218847502,3219967064,-998880438
2000,Zambia,Africa,18441695,30340365,11898670
2000,Zimbabwe,Africa,88402976,101105969,12702993
2000,French South Antarctic Territory,Antarctica,23400,513243,489843
2000,Afghanistan,Asia,722338,7926968,7204630
2000,United Arab Emirates,Asia,810702638,2134623477,1323920839
2000,Armenia,Asia,41781818,91251308,49469490
2000,Azerbaijan,Asia,19146691,262507152,243360461
2000,Bangladesh,Asia,2740501992,317218283,-2423283709
2000,Bahrain,Asia,411263824,443120252,31856428
2000,Brunei,Asia,351759399,143303641,-208455758
2000,Bhutan,Asia,805053,710293,-94760
2000,Cocos (Keeling) Islands,Asia,327664,955270,627606
2000,China,Asia,73527625814,16382715788,-57144910026
2000,Christmas Island,Asia,245086,1274846,1029760
2000,Cyprus,Asia,28996503,272046023,243049520
2000,Georgia,Asia,29839452,127498015,97658563
2000,Hong Kong,Asia,11640874043,14456596954,2815722911
2000,Indonesia,Asia,9618232023,3063866445,-6554365578
2000,India,Asia,9845354113,3601820293,-6243533820
2000,British Indian Ocean Territory,Asia,2588964,978099,-1610865
2000,Iran,Asia,155216254,101137393,-54078861
2000,Iraq,Asia,5271144102,10448409,-5260695693
2000,Israel,Asia,13065353369,7745340102,-5320013267
2000,Jordan,Asia,106856779,392236755,285379976
2000,Japan,Asia,1.38546E+11,67135268873,-71410518952
2000,Kazakhstan,Asia,424990872,129672823,-295318049
2000,Kyrgyzstan,Asia,3428880,46639411,43210531
2000,Cambodia,Asia,1233916346,47100194,-1186816152
2000,South Korea,Asia,38764210786,29114001388,-9650209398
2000,Kuwait,Asia,2394295440,870299397,-1523996043
2000,Laos,Asia,9561135,3670729,-5890406
2000,Lebanon,Asia,69628033,461769657,392141624
2000,Sri Lanka,Asia,2184850384,342671893,-1842178491
2000,Macau,Asia,1270413311,120614803,-1149798508
2000,Maldives,Asia,50266625,12451071,-37815554
2000,Burma,Asia,467845328,16713410,-451131918
2000,Mongolia,Asia,141878327,32314319,-109564008
2000,Malaysia,Asia,23119242352,8221750018,-14897492334
2000,Nepal,Asia,233755531,35282706,-198472825
2000,Oman,Asia,247698858,259183224,11484366
2000,Pakistan,Asia,2142089490,405266299,-1736823191
2000,Philippines,Asia,14201847144,7957611762,-6244235382
2000,North Korea,Asia,153585,2637333,2483748
2000,Palestine,Asia,4810530,9072198,4261668
2000,Qatar,Asia,557764147,307490790,-250273357
2000,Saudi Arabia,Asia,12601684676,6083008280,-6518676396
2000,Singapore,Asia,20687199137,18252082937,-2435116200
2000,Syria,Asia,146950831,224413143,77462312
2000,Thailand,Asia,15289088428,5878280343,-9410808085
2000,Tajikistan,Asia,8889401,10405113,1515712
2000,Turkmenistan,Asia,36501127,90957829,54456702
2000,Turkey,Asia,3279271617,4317711564,1038439947
2000,Uzbekistan,Asia,40105995,147211620,107105625
2000,Vietnam,Asia,886369038,416149060,-470219978
2000,Chinese Taipei,Asia,37701288492,22588933292,-15112355200
2000,Yemen,Asia,215895297,187054803,-28840494
2000,Albania,Europe,7118791,25547409,18428618
2000,Andorra,Europe,825627,24674223,23848596
2000,Austria,Europe,3248628857,3247951840,-677017
2000,Belgium,Europe,10347998571,14053344185,3705345614
2000,Bulgaria,Europe,231963632,198112314,-33851318
2000,Bosnia and Herzegovina,Europe,14878422,40451457,25573035
2000,Belarus,Europe,113546200,95586102,-17960098
2000,Switzerland,Europe,10455048355,9692818866,-762229489
2000,Czechia,Europe,926190675,1155260722,229070047
2000,Germany,Europe,56015497702,32810765207,-23204732495
2000,Denmark,Europe,3002379493,1747428213,-1254951280
2000,Spain,Europe,5695667852,7175878068,1480210216
2000,Estonia,Europe,217655671,125133779,-92521892
2000,Finland,Europe,3567587437,1959209539,-1608377898
2000,France,Europe,25531857320,22974271730,-2557585590
2000,United Kingdom,Europe,42295144868,42928224030,633079162
2000,Gibraltar,Europe,433340,13430995,12997655
2000,Greece,Europe,683970871,1322606622,638635751
2000,Croatia,Europe,174635194,231218465,56583271
2000,Hungary,Europe,2277243061,952368799,-1324874262
2000,Ireland,Europe,15133050139,7760843454,-7372206685
2000,Iceland,Europe,236712326,279171053,42458727
2000,Italy,Europe,24348819166,12078019037,-12270800129
2000,Lithuania,Europe,209573093,115470240,-94102853
2000,Luxembourg,Europe,329904525,535283969,205379444
2000,Latvia,Europe,125204354,153809766,28605412
2000,Moldova,Europe,84933658,47495733,-37437925
2000,North Macedonia,Europe,191076990,76236697,-114840293
2000,Malta,Europe,479510255,403071728,-76438527
2000,Netherlands,Europe,9303686821,21087807560,11784120739
2000,Norway,Europe,4939624289,2619307292,-2320316997
2000,Poland,Europe,1140101431,1688542923,548441492
2000,Portugal,Europe,1485441161,1214036538,-271404623
2000,Romania,Europe,449393184,380219428,-69173756
2000,Russia,Europe,6927824712,2629183920,-4298640792
2000,San Marino,Europe,7103494,878981,-6224513
2000,Slovakia,Europe,220553118,200851895,-19701223
2000,Slovenia,Europe,311551007,259283750,-52267257
2000,Sweden,Europe,8408868991,4913127565,-3495741426
2000,Ukraine,Europe,777037604,378661021,-398376583
2000,Yugoslavia,Europe,3852697,74945910,71093213
2000,Aruba,North America,1336525240,270573083,-1065952157
2000,Anguilla,North America,3012489,47804685,44792196
2000,Netherlands Antilles,North America,553817793,628034342,74216549
2000,Antigua and Barbuda,North America,4996453,176454037,171457584
2000,Bahamas,North America,453044379,1088214844,635170465
2000,Belize,North America,125337043,246154584,120817541
2000,Bermuda,North America,7225240,360730360,353505120
2000,Barbados,North America,48248925,432484294,384235369
2000,Canada,North America,2.24795E+11,1.65025E+11,-59769988876
2000,Costa Rica,North America,3065552519,3119974300,54421781
2000,Cuba,North America,284688,5275680,4990992
2000,Cayman Islands,North America,3708417,240702664,236994247
2000,Dominica,North America,6087978,60114587,54026609
2000,Dominican Republic,North America,4248735831,4330441854,81706023
2000,Grenada,North America,53530490,109884151,56353661
2000,Greenland,North America,13487666,990399,-12497267
2000,Guatemala,North America,1272833561,2406898965,1134065404
2000,Honduras,North America,2489934289,2484795756,-5138533
2000,Haiti,North America,293278215,521906668,228628453
2000,Jamaica,North America,602482376,1485856542,883374166
2000,Saint Kitts and Nevis,North America,33248320,101324166,68075846
2000,Saint Lucia,North America,19667587,146008189,126340602
2000,Mexico,North America,1.40142E+11,1.11733E+11,-28408222827
2000,Montserrat,North America,273730,14886911,14613181
2000,Nicaragua,North America,388717780,467220618,78502838
2000,Panama,North America,345483446,1574175305,1228691859
2000,El Salvador,North America,688608653,1897859491,1209250838
2000,Saint Pierre and Miquelon,North America,5984525,1327704,-4656821
2000,Turks and Caicos Islands,North America,4285592,48791630,44506038
2000,Trinidad and Tobago,North America,2066307697,1319478593,-746829104
2000,Saint Vincent and the Grenadines,North America,9186185,64958248,55772063
2000,British Virgin Islands,North America,22235064,54797153,32562089
2000,Australia,Oceania,6088698136,13626225835,7537527699
2000,Cook Islands,Oceania,2034281,1002113,-1032168
2000,Fiji,Oceania,137762612,18354094,-119408518
2000,Micronesia,Oceania,13640764,24329114,10688350
2000,Kiribati,Oceania,775924,2591573,1815649
2000,Marshall Islands,Oceania,347933,54010846,53662913
2000,New Caledonia,Oceania,32928243,38489861,5561618
2000,Norfolk Island,Oceania,614351,1177392,563041
2000,Niue,Oceania,25257,145538,120281
2000,Nauru,Oceania,1285394,3755347,2469953
2000,New Zealand,Oceania,1948796252,2293606236,344809984
2000,Pitcairn Islands,Oceania,309723,2421916,2112193
2000,Palau,Oceania,13460017,15204422,1744405
2000,Papua New Guinea,Oceania,64203350,71326856,7123506
2000,French Polynesia,Oceania,31107143,140151019,109043876
2000,Solomon Islands,Oceania,361845,3956448,3594603
2000,Tokelau,Oceania,4364330,9865777,5501447
2000,Tonga,Oceania,2650400,7555392,4904992
2000,Tuvalu,Oceania,5547,26853,21306
2000,Vanuatu,Oceania,524990,738725,213735
2000,Samoa,Oceania,3550203,62070292,58520089
2000,Argentina,South America,3173044101,4905975303,1732931202
2000,Bolivia,South America,365608649,428567614,62958965
2000,Brazil,South America,13917730560,15536297311,1618566751
2000,Chile,South America,3057797195,3782427226,724630031
2000,Colombia,South America,6802132345,4248047673,-2554084672
2000,Ecuador,South America,2038319092,1202746849,-835572243
2000,Falkland Islands,South America,2972910,182418,-2790492
2000,Guyana,South America,177713559,219755997,42042438
2000,Peru,South America,1963001773,1841358945,-121642828
2000,Paraguay,South America,48079730,417882362,369802632
2000,Suriname,South America,122307321,152838064,30530743
2000,Uruguay,South America,268819056,424636034,155816978
2000,Venezuela,South America,18406428333,6421878347,-11984549986
2001,Angola,Africa,2683902337,270406908,-2413495429
2001,Burundi,Africa,2412189,7422698,5010509
2001,Benin,Africa,1143963,42930489,41786526
2001,Burkina Faso,Africa,1433313,25068890,23635577
2001,Botswana,Africa,21128126,47501554,26373428
2001,Central African Republic,Africa,2420279,4514338,2094059
2001,Cote d'Ivoire,Africa,294599709,171292100,-123307609
2001,Cameroon,Africa,83774351,223046266,139271915
2001,Democratic Republic of the Congo,Africa,138490099,17805973,-120684126
2001,Republic of the Congo,Africa,415119694,87354725,-327764969
2001,Comoros,Africa,9490025,1348107,-8141918
2001,Cape Verde,Africa,2572274,12289015,9716741
2001,Djibouti,Africa,159063,10680079,10521016
2001,Algeria,Africa,2692347482,1245235399,-1447112083
2001,Egypt,Africa,906347932,3652186577,2745838645
2001,Eritrea,Africa,87184,19304571,19217387
2001,Ethiopia,Africa,27792391,140676979,112884588
2001,Gabon,Africa,1617971510,136672719,-1481298791
2001,Ghana,Africa,178718332,250670140,71951808
2001,Guinea,Africa,80040718,77293082,-2747636
2001,Gambia,Africa,505167,11688513,11183346
2001,Guinea-Bissau,Africa,18933,451505,432572
2001,Equatorial Guinea,Africa,401884696,79084753,-322799943
2001,Kenya,Africa,82689217,611217123,528527906
2001,Liberia,Africa,39050613,31016336,-8034277
2001,Lesotho,Africa,237551795,2613123,-234938672
2001,Morocco,Africa,419893344,415945789,-3947555
2001,Madagascar,Africa,226176920,46190107,-179986813
2001,Mali,Africa,15137088,63614537,48477449
2001,Mozambique,Africa,7218935,33749865,26530930
2001,Mauritania,Africa,428796,45530736,45101940
2001,Mauritius,Africa,307845514,61291329,-246554185
2001,Malawi,Africa,102853746,20391282,-82462464
2001,Mayotte,Africa,15752,2432322,2416570
2001,Namibia,Africa,59463098,211509940,152046842
2001,Niger,Africa,7828023,94136566,86308543
2001,Nigeria,Africa,8721332077,1099935141,-7621396936
2001,Rwanda,Africa,7722288,26198061,18475773
2001,Sudan,Africa,2723761,39931493,37207732
2001,Senegal,Africa,12735123,100560985,87825862
2001,Saint Helena,Africa,3233681,4234070,1000389
2001,Sierra Leone,Africa,4535856,23902068,19366212
2001,Somalia,Africa,266176,5088515,4822339
2001,Sao Tome and Principe,Africa,292393,10839419,10547026
2001,Eswatini,Africa,72716704,13963314,-58753390
2001,Seychelles,Africa,20248645,183747178,163498533
2001,Chad,Africa,5340099,133468362,128128263
2001,Togo,Africa,14117488,23128820,9011332
2001,Tunisia,Africa,128007665,366417059,238409394
2001,Tanzania,Africa,26689727,86521885,59832158
2001,Uganda,Africa,13444928,37600332,24155404
2001,South Africa,Africa,4201192845,2983042451,-1218150394
2001,Zambia,Africa,18752601,23515769,4763168
2001,Zimbabwe,Africa,73163794,48270650,-24893144
2001,French South Antarctic Territory,Antarctica,189699,587879,398180
2001,Afghanistan,Asia,602308,5744751,5142443
2001,United Arab Emirates,Asia,1021466029,2551122001,1529655972
2001,Armenia,Asia,59024738,86654190,27629452
2001,Azerbaijan,Asia,20291683,223783987,203492304
2001,Bangladesh,Asia,2879338689,375611557,-2503727132
2001,Bahrain,Asia,430931610,414615350,-16316260
2001,Brunei,Asia,358261043,123735569,-234525474
2001,Bhutan,Asia,928484,721427,-207057
2001,Cocos (Keeling) Islands,Asia,390794,2858607,2467813
2001,China,Asia,77588256668,19428425254,-58159831414
2001,Christmas Island,Asia,165992,1540087,1374095
2001,Cyprus,Asia,27804320,425496650,397692330
2001,Georgia,Asia,31731595,121529529,89797934
2001,Hong Kong,Asia,10463838434,13866995799,3403157365
2001,Indonesia,Asia,9160889047,2994414256,-6166474791
2001,India,Asia,9007225776,3832451180,-5174774596
2001,British Indian Ocean Territory,Asia,165229,452472,287243
2001,Iran,Asia,138923219,75761471,-63161748
2001,Iraq,Asia,5061856702,46205526,-5015651176
2001,Israel,Asia,12399413847,7725341176,-4674072671
2001,Jordan,Asia,404208666,450079799,45871133
2001,Japan,Asia,1.1903E+11,59722698520,-59307588871
2001,Kazakhstan,Asia,379511457,302909165,-76602292
2001,Kyrgyzstan,Asia,9325298,29876132,20550834
2001,Cambodia,Asia,1427247531,36854328,-1390393203
2001,South Korea,Asia,32405052253,23122526597,-9282525656
2001,Kuwait,Asia,1656528193,950624477,-705903716
2001,Laos,Asia,3848205,3518171,-330034
2001,Lebanon,Asia,71491846,549920052,478428206
2001,Sri Lanka,Asia,2033078700,296407502,-1736671198
2001,Macau,Asia,1154866899,161027536,-993839363
2001,Maldives,Asia,74157169,10311327,-63845842
2001,Burma,Asia,467146680,37091886,-430054794
2001,Mongolia,Asia,165158085,20606491,-144551594
2001,Malaysia,Asia,20540398991,7574652063,-12965746928
2001,Nepal,Asia,194484449,12664549,-181819900
2001,Oman,Asia,395065187,444198120,49132933
2001,Pakistan,Asia,2226833913,481395035,-1745438878
2001,Philippines,Asia,10759011591,6939207835,-3819803756
2001,North Korea,Asia,26197,85473,59276
2001,Palestine,Asia,6169126,2222939,-3946187
2001,Qatar,Asia,577255646,497595392,-79660254
2001,Saudi Arabia,Asia,11664996939,5791253540,-5873743399
2001,Singapore,Asia,16322917167,18034850621,1711933454
2001,Syria,Asia,182036535,412506969,230470434
2001,Thailand,Asia,13802826804,6109292662,-7693534142
2001,Tajikistan,Asia,5189334,20479619,15290285
2001,Turkmenistan,Asia,44003602,242045609,198042007
2001,Turkey,Asia,3205795489,3358674599,152879110
2001,Uzbekistan,Asia,52444846,126042164,73597318
2001,Vietnam,Asia,1169172704,508640427,-660532277
2001,Chinese Taipei,Asia,30915825848,16561047805,-14354778043
2001,Yemen,Asia,173500935,183168157,9667222
2001,Albania,Europe,7250699,21700587,14449888
2001,Andorra,Europe,433421,19449947,19016526
2001,Austria,Europe,3698014742,3412984295,-285030447
2001,Belgium,Europe,10282290171,13412420449,3130130278
2001,Bulgaria,Europe,308475191,164667238,-143807953
2001,Bosnia and Herzegovina,Europe,10502729,41426127,30923398
2001,Belarus,Europe,102022364,111312198,9289834
2001,Switzerland,Europe,9388456161,8806349264,-582106897
2001,Czechia,Europe,1077189969,1179013629,101823660
2001,Germany,Europe,59741364797,32816475563,-26924889234
2001,Denmark,Europe,3508947094,1748481281,-1760465813
2001,Spain,Europe,5125275110,6384537066,1259261956
2001,Estonia,Europe,138694994,101153092,-37541902
2001,Finland,Europe,4288510362,1922684433,-2365825929
2001,France,Europe,25423774723,22502015934,-2921758789
2001,United Kingdom,Europe,40012399766,42044435577,2032035811
2001,Gibraltar,Europe,1318033,9153237,7835204
2001,Greece,Europe,588725080,1367707937,778982857
2001,Croatia,Europe,176249084,268936203,92687119
2001,Hungary,Europe,2367870720,1159347144,-1208523576
2001,Ireland,Europe,15828153214,7273770572,-8554382642
2001,Iceland,Europe,219757397,247176742,27419345
2001,Italy,Europe,23337874568,10979465283,-12358409285
2001,Lithuania,Europe,206358126,186563166,-19794960
2001,Luxembourg,Europe,292717942,649993192,357275250
2001,Latvia,Europe,137349261,127482164,-9867097
2001,Moldova,Europe,60541765,39456854,-21084911
2001,North Macedonia,Europe,115759236,42299060,-73460176
2001,Malta,Europe,391567127,305709116,-85858011
2001,Netherlands,Europe,9213006248,19344082812,10131076564
2001,Norway,Europe,4731283704,2336227809,-2395055895
2001,Poland,Europe,960423638,1268160039,307736401
2001,Portugal,Europe,1471849429,1418696691,-53152738
2001,Romania,Europe,483016046,608157845,125141799
2001,Russia,Europe,5800898824,3350755338,-2450143486
2001,San Marino,Europe,2357881,3512270,1154389
2001,Slovakia,Europe,218848183,174361879,-44486304
2001,Slovenia,Europe,275346357,259706074,-15640283
2001,Sweden,Europe,8371913065,3715055805,-4656857260
2001,Ukraine,Europe,595190457,395742348,-199448109
2001,Yugoslavia,Europe,8294137,118704251,110410114
2001,Aruba,North America,936485049,258150737,-678334312
2001,Anguilla,North America,1399793,34320637,32920844
2001,Netherlands Antilles,North America,343474697,762986619,419511922
2001,Antigua and Barbuda,North America,1378646,81250129,79871483
2001,Bahamas,North America,351767121,1062361896,710594775
2001,Belize,North America,54352962,202318863,147965901
2001,Bermuda,North America,10670266,321280380,310610114
2001,Barbados,North America,49261072,408223550,358962478
2001,Canada,North America,2.10191E+11,1.50118E+11,-60072220816
2001,Costa Rica,North America,2539980431,3344922964,804942533
2001,Cuba,North America,5565,4357023,4351458
2001,Cayman Islands,North America,3570900,190618786,187047886
2001,Dominica,North America,3429469,51574897,48145428
2001,Dominican Republic,North America,3614360829,4250527223,636166394
2001,Grenada,North America,25323760,89925336,64601576
2001,Greenland,North America,16176546,4875980,-11300566
2001,Guatemala,North America,1082354305,2679837313,1597483008
2001,Honduras,North America,2198211233,2240745641,42534408
2001,Haiti,North America,258892501,490111242,231218741
2001,Jamaica,North America,487561058,1528518378,1040957320
2001,Saint Kitts and Nevis,North America,37340674,83992970,46652296
2001,Saint Lucia,North America,25502638,115465375,89962737
2001,Mexico,North America,1.33951E+11,1.0235E+11,-31601142674
2001,Montserrat,North America,184607,11109011,10924404
2001,Nicaragua,North America,387451109,496220648,108769539
2001,Panama,North America,345975575,1325031724,979056149
2001,El Salvador,North America,583007474,1877383399,1294375925
2001,Saint Pierre and Miquelon,North America,3389786,530805,-2858981
2001,Turks and Caicos Islands,North America,3826405,43776897,39950492
2001,Trinidad and Tobago,North America,2554998272,1381158308,-1173839964
2001,Saint Vincent and the Grenadines,North America,21137977,71779493,50641516
2001,British Virgin Islands,North America,5588430,64752380,59163950
2001,Australia,Oceania,6009126902,11617373956,5608247054
2001,Cook Islands,Oceania,453562,630091,176529
2001,Fiji,Oceania,167760774,14973970,-152786804
2001,Micronesia,Oceania,18459592,25515703,7056111
2001,Kiribati,Oceania,911626,4244682,3333056
2001,Marshall Islands,Oceania,371473,23127691,22756218
2001,New Caledonia,Oceania,10477233,38834753,28357520
2001,Norfolk Island,Oceania,430037,92134,-337903
2001,Niue,Oceania,31051,139643,108592
2001,Nauru,Oceania,86645,3918915,3832270
2001,New Zealand,Oceania,2020381063,2205748728,185367665
2001,Pitcairn Islands,Oceania,194287,5049968,4855681
2001,Palau,Oceania,13822479,14713544,891065
2001,Papua New Guinea,Oceania,55981775,83114619,27132844
2001,French Polynesia,Oceania,40237072,115837934,75600862
2001,Solomon Islands,Oceania,2356456,6120396,3763940
2001,Tokelau,Oceania,9058878,9612365,553487
2001,Tonga,Oceania,4135738,5548624,1412886
2001,Vanuatu,Oceania,744392,348488,-395904
2001,Wallis and Futuna,Oceania,2537,449203,446666
2001,Samoa,Oceania,18193473,76402596,58209123
2001,Argentina,South America,2933321731,4031314481,1097992750
2001,Bolivia,South America,193941199,318013675,124072476
2001,Brazil,South America,14729026024,16069761144,1340735120
2001,Chile,South America,3500090939,3434592172,-65498767
2001,Colombia,South America,5384793884,4499781145,-885012739
2001,Ecuador,South America,1832068631,1540297904,-291770727
2001,Falkland Islands,South America,6480246,341282,-6138964
2001,Guyana,South America,171020836,217907210,46886374
2001,Peru,South America,1720497125,1787309986,66812861
2001,Paraguay,South America,42717847,378931410,336213563
2001,Suriname,South America,135471063,168045141,32574078
2001,Uruguay,South America,194500717,333522773,139022056
2001,Venezuela,South America,14365274577,6540057668,-7825216909
2002,Angola,Africa,2846908001,365574446,-2481333555
2002,Burundi,Africa,764499,2516877,1752378
2002,Benin,Africa,1121248,39094608,37973360
2002,Burkina Faso,Africa,3519284,26511667,22992383
2002,Botswana,Africa,40062969,40605629,542660
2002,Central African Republic,Africa,2055173,6212090,4156917
2002,Cote d'Ivoire,Africa,391126964,113790149,-277336815
2002,Cameroon,Africa,149879107,202826513,52947406
2002,Democratic Republic of the Congo,Africa,189191759,21559665,-167632094
2002,Republic of the Congo,Africa,169296744,49845385,-119451359
2002,Comoros,Africa,5182764,134720,-5048044
2002,Cape Verde,Africa,2851793,17876219,15024426
2002,Djibouti,Africa,174701,57238046,57063345
2002,Algeria,Africa,2573834719,1167955000,-1405879719
2002,Egypt,Africa,1001821619,3045246234,2043424615
2002,Eritrea,Africa,183828,27253204,27069376
2002,Ethiopia,Africa,24979038,66849503,41870465
2002,Gabon,Africa,1619575829,64220148,-1555355681
2002,Ghana,Africa,116644133,251662652,135018519
2002,Guinea,Africa,84141082,74275378,-9865704
2002,Gambia,Africa,942430,14727956,13785526
2002,Guinea-Bissau,Africa,38708,2520295,2481587
2002,Equatorial Guinea,Africa,460291110,106898627,-353392483
2002,Kenya,Africa,166706054,300939504,134233450
2002,Liberia,Africa,43377023,23297205,-20079818
2002,Lesotho,Africa,367650977,9835712,-357815265
2002,Morocco,Africa,416120594,632176750,216056156
2002,Madagascar,Africa,170785550,27871255,-142914295
2002,Mali,Africa,4328991,36233836,31904845
2002,Mozambique,Africa,9966358,114476069,104509711
2002,Mauritania,Africa,844441,32240360,31395919
2002,Mauritius,Africa,343889190,70125085,-273764105
2002,Malawi,Africa,92970133,36720540,-56249593
2002,Mayotte,Africa,9245,2079018,2069773
2002,Namibia,Africa,90338529,60638801,-29699728
2002,Niger,Africa,13899279,54003669,40104390
2002,Nigeria,Africa,5494636319,1245305679,-4249330640
2002,Rwanda,Africa,3460316,13019640,9559324
2002,Sudan,Africa,1054156,23611572,22557416
2002,Senegal,Africa,3636921,134024756,130387835
2002,Saint Helena,Africa,4042729,2065786,-1976943
2002,Sierra Leone,Africa,4002221,27613326,23611105
2002,Somalia,Africa,345328,6048565,5703237
2002,Sao Tome and Principe,Africa,375720,2004934,1629214
2002,Eswatini,Africa,156248150,13305249,-142942901
2002,Seychelles,Africa,24095323,10785616,-13309707
2002,Chad,Africa,5694264,123533583,117839319
2002,Togo,Africa,3170174,20523317,17353143
2002,Tunisia,Africa,93738796,270961511,177222715
2002,Tanzania,Africa,24657388,106034200,81376812
2002,Uganda,Africa,14150664,35214446,21063782
2002,South Africa,Africa,4130110445,2754308125,-1375802320
2002,Zambia,Africa,13541368,41472412,27931044
2002,Zimbabwe,Africa,103603177,91673016,-11930161
2002,French South Antarctic Territory,Antarctica,6844,693567,686723
2002,Afghanistan,Asia,638117,76099610,75461493
2002,United Arab Emirates,Asia,794386784,3492914960,2698528176
2002,Armenia,Asia,51710619,117230801,65520182
2002,Azerbaijan,Asia,59123791,101164254,42040463
2002,Bangladesh,Asia,2478287170,336283165,-2142004005
2002,Bahrain,Asia,464743702,375644919,-89098783
2002,Brunei,Asia,333664124,238957645,-94706479
2002,Bhutan,Asia,850921,879277,28356
2002,Cocos (Keeling) Islands,Asia,271944,908614,636670
2002,China,Asia,97701880381,22396018671,-75305861710
2002,Christmas Island,Asia,504689,1120524,615835
2002,Cyprus,Asia,25850052,292883404,267033352
2002,Georgia,Asia,20367596,119670148,99302552
2002,Hong Kong,Asia,9559988197,12547873599,2987885402
2002,Indonesia,Asia,9378862075,2845152034,-6533710041
2002,India,Asia,11245773122,4201192354,-7044580768
2002,British Indian Ocean Territory,Asia,284122,438495,154373
2002,Iran,Asia,163500889,74889516,-88611373
2002,Iraq,Asia,3261217787,31607458,-3229610329
2002,Israel,Asia,12804851595,7100538299,-5704313296
2002,Jordan,Asia,610921258,485730745,-125190513
2002,Japan,Asia,1.17138E+11,54498949862,-62639077790
2002,Kazakhstan,Asia,261399708,701455018,440055310
2002,Kyrgyzstan,Asia,33124041,49901687,16777646
2002,Cambodia,Asia,1824002568,31571063,-1792431505
2002,South Korea,Asia,33933862403,22747310872,-11186551531
2002,Kuwait,Asia,1752323234,1097347641,-654975593
2002,Laos,Asia,2704738,4046298,1341560
2002,Lebanon,Asia,67280528,427927023,360646495
2002,Sri Lanka,Asia,1907386198,259300202,-1648085996
2002,Macau,Asia,1211916914,145364113,-1066552801
2002,Maldives,Asia,63210291,6390520,-56819771
2002,Burma,Asia,377712631,9727944,-367984687
2002,Mongolia,Asia,160182111,64915587,-95266524
2002,Malaysia,Asia,21559211143,10089814540,-11469396603
2002,Nepal,Asia,162859268,17553483,-145305785
2002,Oman,Asia,324909479,487469484,162560005
2002,Pakistan,Asia,2457729243,651476386,-1806252857
2002,Philippines,Asia,10489391221,6583529712,-3905861509
2002,North Korea,Asia,77555,24365884,24288329
2002,Palestine,Asia,9051515,177467,-8874048
2002,Qatar,Asia,508402857,461824119,-46578738
2002,Saudi Arabia,Asia,12227467556,4635106931,-7592360625
2002,Singapore,Asia,16161543503,15442129318,-719414185
2002,Syria,Asia,360943970,655751295,294807325
2002,Thailand,Asia,14304143823,5145482662,-9158661161
2002,Tajikistan,Asia,1089449,11979177,10889728
2002,Turkmenistan,Asia,62118653,44515359,-17603294
2002,Turkey,Asia,3510619472,3260757021,-249862451
2002,Uzbekistan,Asia,79921457,120685302,40763845
2002,Vietnam,Asia,2808727935,644951205,-2163776730
2002,Chinese Taipei,Asia,30059987082,17115692525,-12944294557
2002,Yemen,Asia,222796224,364912177,142115953
2002,Albania,Europe,8611172,26508415,17897243
2002,Andorra,Europe,651634,19855095,19203461
2002,Austria,Europe,3917665282,2992587577,-925077705
2002,Belgium,Europe,14539888281,13825283470,-714604811
2002,Bulgaria,Europe,313383961,162008944,-151375017
2002,Bosnia and Herzegovina,Europe,15729149,30717472,14988323
2002,Belarus,Europe,136247016,79763616,-56483400
2002,Switzerland,Europe,10601768513,7897974054,-2703794459
2002,Czechia,Europe,1587023663,1137152394,-449871269
2002,Germany,Europe,64012025915,30674704944,-33337320971
2002,Denmark,Europe,3327502248,1840862458,-1486639790
2002,Spain,Europe,5595999588,5988442219,392442631
2002,Estonia,Europe,147582993,134998871,-12584122
2002,Finland,Europe,4361372489,1781225875,-2580146614
2002,France,Europe,24659526418,20942936179,-3716590239
2002,United Kingdom,Europe,40365912064,34633255576,-5732656488
2002,Gibraltar,Europe,845779,19919869,19074090
2002,Greece,Europe,598055414,1389018932,790963518
2002,Croatia,Europe,184792324,272625559,87833235
2002,Hungary,Europe,1560440885,1123073590,-437367295
2002,Ireland,Europe,20403121994,7018490592,-13384631402
2002,Iceland,Europe,248306736,245457833,-2848903
2002,Italy,Europe,24079094697,11193895805,-12885198892
2002,Lithuania,Europe,265162405,216987512,-48174893
2002,Luxembourg,Europe,304476038,574329406,269853368
2002,Latvia,Europe,131011704,106064091,-24947613
2002,Moldova,Europe,41949580,49928828,7979248
2002,North Macedonia,Europe,85394637,41245850,-44148787
2002,Malta,Europe,448579634,260566814,-188012820
2002,Netherlands,Europe,10008997322,18228090819,8219093497
2002,Norway,Europe,5549663716,1912973370,-3636690346
2002,Poland,Europe,1320894232,1362237873,41343641
2002,Portugal,Europe,1587906166,926687914,-661218252
2002,Romania,Europe,718539637,471112794,-247426843
2002,Russia,Europe,5933921784,2811939963,-3121981821
2002,San Marino,Europe,1298389,5690664,4392275
2002,Slovakia,Europe,243539737,214996801,-28542936
2002,Slovenia,Europe,349162995,271836897,-77326098
2002,Sweden,Europe,9294584976,3297179011,-5997405965
2002,Ukraine,Europe,574073737,479634345,-94439392
2002,Yugoslavia,Europe,18772560,127671127,108898567
2002,Aruba,North America,731224354,438011794,-293212560
2002,Anguilla,North America,2095745,32305651,30209906
2002,Netherlands Antilles,North America,267508341,697947898,430439557
2002,Antigua and Barbuda,North America,1247016,68419195,67172179
2002,Bahamas,North America,446564527,994796135,548231608
2002,Belize,North America,66698232,170060126,103361894
2002,Bermuda,North America,8077790,365413177,357335387
2002,Barbados,North America,35917199,393053292,357136093
2002,Canada,North America,2.03376E+11,1.48816E+11,-54559944489
2002,Costa Rica,North America,2974325284,3610377186,636051902
2002,Cuba,North America,188096,192626576,192438480
2002,Cayman Islands,North America,2595030,173742494,171147464
2002,Dominica,North America,5798182,60320773,54522591
2002,Dominican Republic,North America,4476015213,4285114459,-190900754
2002,Grenada,North America,11530931,79213931,67683000
2002,Greenland,North America,11496486,4131739,-7364747
2002,Guatemala,North America,1092454917,2876079544,1783624627
2002,Honduras,North America,2097787084,2334535553,236748469
2002,Haiti,North America,258084071,493458756,235374685
2002,Jamaica,North America,397402822,1447365540,1049962718
2002,Saint Kitts and Nevis,North America,46715134,91353550,44638416
2002,Saint Lucia,North America,19561667,133062036,113500369
2002,Mexico,North America,1.37001E+11,97855003923,-39145533338
2002,Montserrat,North America,377746,13177688,12799942
2002,Nicaragua,North America,540566100,478685339,-61880761
2002,Panama,North America,374199422,1418060915,1043861493
2002,El Salvador,North America,614105515,1750242223,1136136708
2002,Saint Pierre and Miquelon,North America,3640663,725483,-2915180
2002,Turks and Caicos Islands,North America,4563859,31614875,27051016
2002,Trinidad and Tobago,North America,2501269558,1250773325,-1250496233
2002,Saint Vincent and the Grenadines,North America,16298702,75200755,58902053
2002,British Virgin Islands,North America,29233588,58388387,29154799
2002,Australia,Oceania,6333875533,13397812015,7063936482
2002,Cook Islands,Oceania,1151774,705147,-446627
2002,Fiji,Oceania,188009332,36380436,-151628896
2002,Micronesia,Oceania,19796259,23124175,3327916
2002,Kiribati,Oceania,937649,2907430,1969781
2002,Marshall Islands,Oceania,5130517,25456500,20325983
2002,New Caledonia,Oceania,8838008,51541135,42703127
2002,Norfolk Island,Oceania,51726,206965,155239
2002,Niue,Oceania,15015,322984,307969
2002,Nauru,Oceania,588294,2728022,2139728
2002,New Zealand,Oceania,2274994572,2020319875,-254674697
2002,Pitcairn Islands,Oceania,132724,5741507,5608783
2002,Palau,Oceania,16412910,15424350,-988560
2002,Papua New Guinea,Oceania,118078719,95577028,-22501691
2002,French Polynesia,Oceania,35608456,116500412,80891956
2002,Solomon Islands,Oceania,810731,884018,73287
2002,Tokelau,Oceania,2582325,17362263,14779938
2002,Tonga,Oceania,5150241,11711908,6561667
2002,Tuvalu,Oceania,2183,95101,92918
2002,Vanuatu,Oceania,2732474,518731,-2213743
2002,Samoa,Oceania,6122444,13860824,7738380
2002,Argentina,South America,3123406487,1890219764,-1233186723
2002,Bolivia,South America,197341412,282205298,84863886
2002,Brazil,South America,16140423667,12529563842,-3610859825
2002,Chile,South America,3587664002,2907223141,-680440861
2002,Colombia,South America,5401830332,4194712085,-1207118247
2002,Ecuador,South America,2112970413,1713261932,-399708481
2002,Falkland Islands,South America,5856983,380901,-5476082
2002,Guyana,South America,143659416,193209832,49550416
2002,Peru,South America,2022907678,1705651497,-317256181
2002,Paraguay,South America,49861309,335676003,285814694
2002,Suriname,South America,129721793,141968250,12246457
2002,Uruguay,South America,154484511,193149077,38664566
2002,Venezuela,South America,13835817847,4689252774,-9146565073
2003,Angola,Africa,3924546724,478198166,-3446348558
2003,Burundi,Africa,6348397,4926381,-1422016
2003,Benin,Africa,1201382,44720115,43518733
2003,Burkina Faso,Africa,1028981,17112601,16083620
2003,Botswana,Africa,24687633,28186200,3498567
2003,Central African Republic,Africa,2086018,7348968,5262950
2003,Cote d'Ivoire,Africa,438973457,137509867,-301463590
2003,Cameroon,Africa,194951538,127786720,-67164818
2003,Democratic Republic of the Congo,Africa,165791799,28730352,-137061447
2003,Republic of the Congo,Africa,401561626,76069276,-325492350
2003,Comoros,Africa,4087396,578701,-3508695
2003,Cape Verde,Africa,5754190,18231910,12477720
2003,Djibouti,Africa,161634,25639183,25477549
2003,Algeria,Africa,4898879404,638798145,-4260081259
2003,Egypt,Africa,1086266861,2796868734,1710601873
2003,Eritrea,Africa,209334,118695038,118485704
2003,Ethiopia,Africa,30998385,456747422,425749037
2003,Gabon,Africa,2013404366,132668416,-1880735950
2003,Ghana,Africa,97476709,278681575,181204866
2003,Guinea,Africa,76424921,29011299,-47413622
2003,Gambia,Africa,175911,28893011,28717100
2003,Guinea-Bissau,Africa,1840895,1254335,-586560
2003,Equatorial Guinea,Africa,834724862,331116351,-503608511
2003,Kenya,Africa,205253021,240834500,35581479
2003,Liberia,Africa,57503892,27634067,-29869825
2003,Lesotho,Africa,787864580,6613251,-781251329
2003,Morocco,Africa,417091945,575441836,158349891
2003,Madagascar,Africa,296548745,77720125,-218828620
2003,Mali,Africa,2915072,69813875,66898803
2003,Mozambique,Africa,12623219,78897228,66274009
2003,Mauritania,Africa,798040,41369256,40571216
2003,Mauritius,Africa,372170360,63393583,-308776777
2003,Malawi,Africa,78198735,31980890,-46217845
2003,Namibia,Africa,152134558,31261988,-120872570
2003,Niger,Africa,12791038,55065472,42274434
2003,Nigeria,Africa,11160940131,1654415075,-9506525056
2003,Rwanda,Africa,2772437,8633963,5861526
2003,Sudan,Africa,2586371,37706208,35119837
2003,Senegal,Africa,10428802,133200979,122772177
2003,Saint Helena,Africa,5698371,2124929,-3573442
2003,Sierra Leone,Africa,6598113,22842198,16244085
2003,Somalia,Africa,143001,6924092,6781091
2003,Sao Tome and Principe,Africa,293821,903281,609460
2003,Eswatini,Africa,343644168,12223035,-331421133
2003,Seychelles,Africa,10910914,9182235,-1728679
2003,Chad,Africa,21624186,62488433,40864247
2003,Togo,Africa,12346656,17475478,5128822
2003,Tunisia,Africa,102273035,243932178,141659143
2003,Tanzania,Africa,24142693,89346626,65203933
2003,Uganda,Africa,25439042,73848683,48409641
2003,South Africa,Africa,4321115877,3020855117,-1300260760
2003,Zambia,Africa,12819743,34130673,21310930
2003,Zimbabwe,Africa,47953721,46463706,-1490015
2003,French South Antarctic Territory,Antarctica,69208,331510,262302
2003,Afghanistan,Asia,49407362,57357291,7949929
2003,United Arab Emirates,Asia,1014957580,3421849187,2406891607
2003,Armenia,Asia,58754275,155635862,96881587
2003,Azerbaijan,Asia,75230329,143266862,68036533
2003,Bangladesh,Asia,2482751673,313054188,-2169697485
2003,Bahrain,Asia,353830148,465170794,111340646
2003,Brunei,Asia,449857564,101664719,-348192845
2003,Bhutan,Asia,505092,987772,482680
2003,Cocos (Keeling) Islands,Asia,243593,548736,305143
2003,China,Asia,1.21508E+11,28445851657,-93062636295
2003,Christmas Island,Asia,256044,980262,724218
2003,Cyprus,Asia,25121800,287458128,262336328
2003,Georgia,Asia,21142065,164717696,143575631
2003,Hong Kong,Asia,9326325408,13649175593,4322850185
2003,Indonesia,Asia,9206567445,2766483510,-6440083935
2003,India,Asia,12295645085,5152285747,-7143359338
2003,British Indian Ocean Territory,Asia,260257,3406526,3146269
2003,Iran,Asia,166686432,141000096,-25686336
2003,Iraq,Asia,4292974235,299424611,-3993549624
2003,Israel,Asia,13053945047,6597230159,-6456714888
2003,Jordan,Asia,939740637,525203065,-414537572
2003,Japan,Asia,1.13416E+11,53929982872,-59486287650
2003,Kazakhstan,Asia,256182831,370608344,114425513
2003,Kyrgyzstan,Asia,10615419,36179011,25563592
2003,Cambodia,Asia,2070942557,63148129,-2007794428
2003,South Korea,Asia,35601936096,24383949093,-11217987003
2003,Kuwait,Asia,2153795359,1541752571,-612042788
2003,Laos,Asia,4419018,4539937,120919
2003,Lebanon,Asia,79894902,421501706,341606804
2003,Sri Lanka,Asia,1934906952,240162908,-1694744044
2003,Macau,Asia,1336438012,142766336,-1193671676
2003,Maldives,Asia,48099517,9290626,-38808891
2003,Burma,Asia,293156156,6694915,-286461241
2003,Mongolia,Asia,180268032,33052590,-147215442
2003,Malaysia,Asia,22010058905,10258371584,-11751687321
2003,Nepal,Asia,201657209,28655189,-173002020
2003,Oman,Asia,555987380,342007930,-213979450
2003,Pakistan,Asia,3386742799,919839057,-2466903742
2003,Philippines,Asia,9903985454,7156952485,-2747032969
2003,Palestine,Asia,1542960,491305,-1051655
2003,Qatar,Asia,305766520,493369284,187602764
2003,Saudi Arabia,Asia,17161861200,4425419057,-12736442143
2003,Singapore,Asia,17707390098,16537546117,-1169843981
2003,Syria,Asia,660382090,585686710,-74695380
2003,Thailand,Asia,14680654612,5744555131,-8936099481
2003,Tajikistan,Asia,7694052,18749938,11055886
2003,Turkmenistan,Asia,79501611,32686125,-46815486
2003,Timor-Leste,Asia,3404165,146779,-3257386
2003,Turkey,Asia,3898601561,3237053736,-661547825
2003,Uzbekistan,Asia,77567640,225921640,148354000
2003,Vietnam,Asia,5080105004,1597481172,-3482623832
2003,Chinese Taipei,Asia,29448029771,16266760723,-13181269048
2003,Yemen,Asia,61810268,190045872,128235604
2003,Albania,Europe,4014237,21804763,17790526
2003,Andorra,Europe,647822,23124299,22476477
2003,Austria,Europe,4613933367,2379452117,-2234481250
2003,Belgium,Europe,14986699957,14935498126,-51201831
2003,Bulgaria,Europe,395148637,243339690,-151808947
2003,Bosnia and Herzegovina,Europe,12224685,55053225,42828540
2003,Belarus,Europe,223613016,155155036,-68457980
2003,Switzerland,Europe,11404244290,8874099104,-2530145186
2003,Czechia,Europe,1298742451,1208608132,-90134319
2003,Germany,Europe,68436024961,34340763508,-34095261453
2003,Denmark,Europe,3857436989,1694776008,-2162660981
2003,Spain,Europe,6575293058,6751120943,175827885
2003,Estonia,Europe,170604124,191838970,21234846
2003,Finland,Europe,4163743658,1835743862,-2327999796
2003,France,Europe,25079498941,19251404223,-5828094718
2003,United Kingdom,Europe,43202740562,35307531289,-7895209273
2003,Gibraltar,Europe,2734211,12656301,9922090
2003,Greece,Europe,892356166,2394621908,1502265742
2003,Croatia,Europe,234741537,384400020,149658483
2003,Hungary,Europe,1705677248,1396224954,-309452294
2003,Ireland,Europe,20963253451,7845948473,-13117304978
2003,Iceland,Europe,230035233,301880542,71845309
2003,Italy,Europe,24716811837,11203427903,-13513383934
2003,Lithuania,Europe,285003191,298167337,13164146
2003,Luxembourg,Europe,287180242,370570439,83390197
2003,Latvia,Europe,392811183,141910244,-250900939
2003,Moldova,Europe,39453342,36914732,-2538610
2003,North Macedonia,Europe,79292566,42413616,-36878950
2003,Malta,Europe,392982751,275180546,-117802205
2003,Netherlands,Europe,11774879047,20585968624,8811089577
2003,Norway,Europe,5905194654,1856199520,-4048995134
2003,Poland,Europe,1364213796,1199886377,-164327419
2003,Portugal,Europe,1912392585,926657962,-985734623
2003,Romania,Europe,741485287,550233756,-191251531
2003,Russia,Europe,5178911195,2814810833,-2364100362
2003,San Marino,Europe,9111230,5826283,-3284947
2003,Slovakia,Europe,1151016218,297824847,-853191371
2003,Slovenia,Europe,662336599,276842647,-385493952
2003,Sweden,Europe,11443078325,3453357470,-7989720855
2003,Ukraine,Europe,729694153,403965816,-325728337
2003,Yugoslavia,Europe,13555275,41020719,27465444
2003,Aruba,North America,911463687,334023709,-577439978
2003,Anguilla,North America,3232108,35763234,32531126
2003,Netherlands Antilles,North America,474262474,700577723,226315249
2003,Antigua and Barbuda,North America,9156945,108999342,99842397
2003,Bahamas,North America,461962638,1051871650,589909012
2003,Belize,North America,134288885,213741257,79452372
2003,Bermuda,North America,2420127,352270129,349850002
2003,Barbados,North America,44264902,413360703,369095801
2003,Canada,North America,2.17848E+11,1.57113E+11,-60735333635
2003,Costa Rica,North America,3014417172,3762867758,748450586
2003,Cuba,North America,279567,318331705,318052138
2003,Cayman Islands,North America,4377227,234487231,230110004
2003,Dominica,North America,3085313,52441464,49356151
2003,Dominican Republic,North America,4789321555,4087888303,-701433252
2003,Grenada,North America,13467614,101036289,87568675
2003,Greenland,North America,7312874,13074318,5761444
2003,Guatemala,North America,1182763880,3023540881,1840777001
2003,Honduras,North America,2182961080,2592914938,409953858
2003,Haiti,North America,334985018,564546345,229561327
2003,Jamaica,North America,411552830,1525722612,1114169782
2003,Saint Kitts and Nevis,North America,53551327,103827149,50275822
2003,Saint Lucia,North America,16871871,180509534,163637663
2003,Mexico,North America,1.42431E+11,98138924211,-44291621557
2003,Montserrat,North America,1375973,14807915,13431942
2003,Nicaragua,North America,741268946,561127638,-180141308
2003,Panama,North America,396409877,1815884764,1419474887
2003,El Salvador,North America,418910813,1906377755,1487466942
2003,Saint Pierre and Miquelon,North America,2657317,78667,-2578650
2003,Turks and Caicos Islands,North America,4928755,43471784,38543029
2003,Trinidad and Tobago,North America,4102340843,1230935837,-2871405006
2003,Saint Vincent and the Grenadines,North America,8570906,81325747,72754841
2003,British Virgin Islands,North America,24024407,62293761,38269354
2003,Australia,Oceania,6056815699,13718307789,7661492090
2003,Cook Islands,Oceania,3105747,1897145,-1208602
2003,Fiji,Oceania,229943931,97476881,-132467050
2003,Micronesia,Oceania,18488869,42797012,24308143
2003,Kiribati,Oceania,1057112,779974,-277138
2003,Marshall Islands,Oceania,5632845,24848523,19215678
2003,New Caledonia,Oceania,11866519,56737033,44870514
2003,Norfolk Island,Oceania,1576579,344279,-1232300
2003,Niue,Oceania,121526,56649,-64877
2003,Nauru,Oceania,295364,1706409,1411045
2003,New Zealand,Oceania,2453585804,2180276294,-273309510
2003,Pitcairn Islands,Oceania,445676,2874183,2428507
2003,Palau,Oceania,1793842,13025554,11231712
2003,Papua New Guinea,Oceania,71758991,97986731,26227740
2003,French Polynesia,Oceania,33144649,137041746,103897097
2003,Solomon Islands,Oceania,1210242,1248247,38005
2003,Tokelau,Oceania,6504562,14334673,7830111
2003,Tonga,Oceania,8591115,6821680,-1769435
2003,Tuvalu,Oceania,7386,72470,65084
2003,Vanuatu,Oceania,840181,717647,-122534
2003,Wallis and Futuna,Oceania,8868,1498219,1489351
2003,Samoa,Oceania,4300058,20876921,16576863
2003,Argentina,South America,3183877402,2455321399,-728556003
2003,Bolivia,South America,237166166,304076603,66910437
2003,Brazil,South America,17673861526,11077918208,-6595943318
2003,Chile,South America,3888294658,2969745719,-918548939
2003,Colombia,South America,6237153439,4268305711,-1968847728
2003,Ecuador,South America,2542428122,1571145408,-971282714
2003,Falkland Islands,South America,4874419,902014,-3972405
2003,Guyana,South America,140235228,170185382,29950154
2003,Peru,South America,2463327398,1852970136,-610357262
2003,Paraguay,South America,58145431,299574971,241429540
2003,Suriname,South America,140948737,229723924,88775187
2003,Uruguay,South America,267986118,241269668,-26716450
2003,Venezuela,South America,12703776631,3194158358,-9509618273
2004,Angola,Africa,4195176581,570823759,-3624352822
2004,Burundi,Africa,3285169,17725247,14440078
2004,Benin,Africa,1820965,47593222,45772257
2004,Burkina Faso,Africa,1146053,29030792,27884739
2004,Botswana,Africa,111999008,46136962,-65862046
2004,Central African Republic,Africa,8678964,18136539,9457575
2004,Cote d'Ivoire,Africa,708037303,152322069,-555715234
2004,Cameroon,Africa,273582120,143621854,-129960266
2004,Democratic Republic of the Congo,Africa,118953030,62782264,-56170766
2004,Republic of the Congo,Africa,791971532,62539198,-729432334
2004,Comoros,Africa,14800555,713541,-14087014
2004,Cape Verde,Africa,4572202,60433182,55860980
2004,Djibouti,Africa,444348,38130311,37685963
2004,Algeria,Africa,7576186110,1148406292,-6427779818
2004,Egypt,Africa,1406654646,3024989288,1618334642
2004,Eritrea,Africa,306944,47707461,47400517
2004,Ethiopia,Africa,45914193,304599758,258685565
2004,Gabon,Africa,2405740169,96136331,-2309603838
2004,Ghana,Africa,147695663,292869150,145173487
2004,Guinea,Africa,72365615,70477136,-1888479
2004,Gambia,Africa,555419,35203182,34647763
2004,Guinea-Bissau,Africa,24612780,1010208,-23602572
2004,Equatorial Guinea,Africa,1097252259,211614690,-885637569
2004,Kenya,Africa,178198355,158549355,-19649000
2004,Liberia,Africa,83587458,50899911,-32687547
2004,Libya,Africa,308156063,38757672,-269398391
2004,Lesotho,Africa,710606813,11316409,-699290404
2004,Morocco,Africa,564382181,661582227,97200046
2004,Madagascar,Africa,368725062,121002949,-247722113
2004,Mali,Africa,6155576,65556331,59400755
2004,Mozambique,Africa,12912862,83899959,70987097
2004,Mauritania,Africa,575580,69408444,68832864
2004,Mauritius,Africa,296397489,61667387,-234730102
2004,Malawi,Africa,71305087,34791421,-36513666
2004,Mayotte,Africa,12103,2870833,2858730
2004,Namibia,Africa,375096788,74428158,-300668630
2004,Niger,Africa,33727892,76399458,42671566
2004,Nigeria,Africa,15022481969,1466421928,-13556060041
2004,Rwanda,Africa,5863100,17847415,11984315
2004,Sudan,Africa,4167876,91650565,87482689
2004,Senegal,Africa,4310344,122999455,118689111
2004,Saint Helena,Africa,4956323,6950690,1994367
2004,Sierra Leone,Africa,11058859,33561685,22502826
2004,Somalia,Africa,690271,8746128,8055857
2004,Sao Tome and Principe,Africa,86974,3442185,3355211
2004,Eswatini,Africa,260422620,15541304,-244881316
2004,Seychelles,Africa,5542134,15843736,10301602
2004,Chad,Africa,723096027,40067176,-683028851
2004,Togo,Africa,3107078,24933487,21826409
2004,Tunisia,Africa,210678481,327942177,117263696
2004,Tanzania,Africa,26527623,99984219,73456596
2004,Uganda,Africa,25041749,92875140,67833391
2004,South Africa,Africa,4988184857,3501464152,-1486720705
2004,Zambia,Africa,37304144,41469945,4165801
2004,Zimbabwe,Africa,85083064,90785889,5702825
2004,French South Antarctic Territory,Antarctica,91183,3264311,3173128
2004,Afghanistan,Asia,4503496,141620833,137117337
2004,United Arab Emirates,Asia,989026801,3732204952,2743178151
2004,Armenia,Asia,76844395,116335776,39491381
2004,Azerbaijan,Asia,45296271,183165930,137869659
2004,Bangladesh,Asia,2768671847,360594253,-2408077594
2004,Bahrain,Asia,396092354,252138064,-143954290
2004,Brunei,Asia,462225407,118349145,-343876262
2004,Bhutan,Asia,149296,1772014,1622718
2004,Cocos (Keeling) Islands,Asia,595153,5397322,4802169
2004,China,Asia,1.5618E+11,35100714168,-1.21079E+11
2004,Christmas Island,Asia,495004,4280883,3785879
2004,Cyprus,Asia,25396049,123249402,97853353
2004,Georgia,Asia,77190025,249082234,171892209
2004,Hong Kong,Asia,10012846202,15463744304,5450898102
2004,Indonesia,Asia,10612754414,3155388618,-7457365796
2004,India,Asia,14637512094,5956165830,-8681346264
2004,British Indian Ocean Territory,Asia,526571,3646386,3119815
2004,Iran,Asia,150050818,125070787,-24980031
2004,Iraq,Asia,7937150736,817697738,-7119452998
2004,Israel,Asia,15016617910,7506194479,-7510423431
2004,Jordan,Asia,1387962695,652319306,-735643389
2004,Japan,Asia,1.23889E+11,54828732038,-69060656220
2004,Kazakhstan,Asia,440613938,489821895,49207957
2004,Kyrgyzstan,Asia,12298155,32918103,20619948
2004,Cambodia,Asia,2198919320,60778789,-2138140531
2004,South Korea,Asia,44377499143,26306561990,-18070937153
2004,Kuwait,Asia,2999838303,1530217756,-1469620547
2004,Laos,Asia,3379492,5569284,2189792
2004,Lebanon,Asia,63079351,579117875,516038524
2004,Sri Lanka,Asia,2013511315,253309307,-1760202008
2004,Macau,Asia,1414487410,149113193,-1265374217
2004,Maldives,Asia,36491955,13789271,-22702684
2004,Mongolia,Asia,205394822,51648829,-153745993
2004,Malaysia,Asia,26888393689,10585369729,-16303023960
2004,Nepal,Asia,154294803,20805059,-133489744
2004,Oman,Asia,436253475,386940384,-49313091
2004,Pakistan,Asia,3565128516,1486673862,-2078454654
2004,Philippines,Asia,9472546506,6375340817,-3097205689
2004,North Korea,Asia,1500879,23750195,22249316
2004,Palestine,Asia,1063119,264311,-798808
2004,Qatar,Asia,336850019,561553811,224703792
2004,Saudi Arabia,Asia,19919531881,5283370077,-14636161804
2004,Singapore,Asia,18903191886,18377116880,-526075006
2004,Syria,Asia,607482927,477959796,-129523131
2004,Thailand,Asia,16842606980,6553828171,-10288778809
2004,Tajikistan,Asia,7551845,42244289,34692444
2004,Turkmenistan,Asia,84350587,89998908,5648321
2004,Timor-Leste,Asia,4338342,5315485,977143
2004,Turkey,Asia,5006800904,4322106816,-684694088
2004,Uzbekistan,Asia,74477923,46180189,-28297734
2004,Vietnam,Asia,6014821006,1286816818,-4728004188
2004,Chinese Taipei,Asia,31669058792,20180835328,-11488223464
2004,Yemen,Asia,104129914,385101299,280971385
2004,Albania,Europe,11714507,38382485,26667978
2004,Andorra,Europe,1259192,24369511,23110319
2004,Austria,Europe,6425695519,2571378848,-3854316671
2004,Belgium,Europe,17573388010,16601405658,-971982352
2004,Bulgaria,Europe,511605695,295284923,-216320772
2004,Bosnia and Herzegovina,Europe,17542517,69351177,51808660
2004,Belarus,Europe,220349584,135892665,-84456919
2004,Switzerland,Europe,12148680848,8700586541,-3448094307
2004,Czechia,Europe,1604618652,1361633299,-242985353
2004,Germany,Europe,77960061124,37854456195,-40105604929
2004,Denmark,Europe,4229812837,2245017228,-1984795609
2004,Spain,Europe,7299637463,7771504311,471866848
2004,Estonia,Europe,314534959,201844975,-112689984
2004,Finland,Europe,4016481755,2026871741,-1989610014
2004,France,Europe,28239007892,20221760457,-8017247435
2004,United Kingdom,Europe,47417170512,33588142547,-13829027965
2004,Gibraltar,Europe,1278950,105706403,104427453
2004,Greece,Europe,911953210,2384035634,1472082424
2004,Croatia,Europe,253234489,354122578,100888089
2004,Hungary,Europe,1913607694,854104531,-1059503163
2004,Ireland,Europe,24801123350,7909789233,-16891334117
2004,Iceland,Europe,274149461,367145916,92996455
2004,Italy,Europe,27565183259,11359698194,-16205485065
2004,Lithuania,Europe,499555836,306490567,-193065269
2004,Luxembourg,Europe,335771947,692490878,356718931
2004,Latvia,Europe,263979415,132210262,-131769153
2004,Moldova,Europe,48526664,48612616,85952
2004,North Macedonia,Europe,75986836,42116973,-33869863
2004,Malta,Europe,718575260,206588184,-511987076
2004,Netherlands,Europe,13449419674,23407417267,9957997593
2004,Norway,Europe,6418601042,1963318201,-4455282841
2004,Poland,Europe,1855862921,1418466102,-437396819
2004,Portugal,Europe,2291273255,1290389199,-1000884056
2004,Romania,Europe,820784134,812413624,-8370510
2004,Russia,Europe,7678250689,3293742902,-4384507787
2004,San Marino,Europe,1710594,3847674,2137080
2004,Slovakia,Europe,1680012634,316034402,-1363978232
2004,Slovenia,Europe,614692978,347190504,-267502474
2004,Sweden,Europe,12235902872,3492569479,-8743333393
2004,Ukraine,Europe,1574939570,540295968,-1034643602
2004,Yugoslavia,Europe,100916973,293761844,192844871
2004,Aruba,North America,1702326188,361887515,-1340438673
2004,Anguilla,North America,2092835,37717062,35624227
2004,Netherlands Antilles,North America,288058172,775909582,487851410
2004,Antigua and Barbuda,North America,2684726,103650753,100966027
2004,Bahamas,North America,585798526,1167179209,581380683
2004,Belize,North America,135740123,168977425,33237302
2004,Bermuda,North America,2392695,328995832,326603137
2004,Barbados,North America,41494202,448860552,407366350
2004,Canada,North America,2.51943E+11,1.74327E+11,-77616440213
2004,Costa Rica,North America,2932786592,3640756639,707970047
2004,Cuba,North America,302510,470811235,470508725
2004,Cayman Islands,North America,5701380,304925822,299224442
2004,Dominica,North America,2435962,57224464,54788502
2004,Dominican Republic,North America,4730200788,4208970810,-521229978
2004,Grenada,North America,7610257,109123029,101512772
2004,Greenland,North America,6722753,4046372,-2676381
2004,Guatemala,North America,1364861277,3219039150,1854177873
2004,Honduras,North America,2384231615,2824164796,439933181
2004,Haiti,North America,375966980,573190954,197223974
2004,Jamaica,North America,341597028,1500561460,1158964432
2004,Saint Kitts and Nevis,North America,51656779,95452718,43795939
2004,Saint Lucia,North America,17079562,164308573,147229011
2004,Mexico,North America,1.56566E+11,1.08381E+11,-48184673518
2004,Montserrat,North America,512599,17660911,17148312
2004,Nicaragua,North America,912823454,582748535,-330074919
2004,Panama,North America,421348974,1611602078,1190253104
2004,El Salvador,North America,655953391,1809421844,1153468453
2004,Saint Pierre and Miquelon,North America,1459668,592357,-867311
2004,Turks and Caicos Islands,North America,6304616,77052741,70748125
2004,Trinidad and Tobago,North America,4863622379,1691391525,-3172230854
2004,Saint Vincent and the Grenadines,North America,5447124,87061063,81613939
2004,British Virgin Islands,North America,12376378,83774609,71398231
2004,Australia,Oceania,7085845758,15181125644,8095279886
2004,Cook Islands,Oceania,3619813,764478,-2855335
2004,Fiji,Oceania,285190727,45325622,-239865105
2004,Micronesia,Oceania,15052476,46877812,31825336
2004,Kiribati,Oceania,975144,675548,-299596
2004,Marshall Islands,Oceania,9603200,15813620,6210420
2004,New Caledonia,Oceania,29563021,58492955,28929934
2004,Norfolk Island,Oceania,2863917,364410,-2499507
2004,Niue,Oceania,201244,342555,141311
2004,Nauru,Oceania,94305,691073,596768
2004,New Zealand,Oceania,2975237396,2299929974,-675307422
2004,Pitcairn Islands,Oceania,612749,2249846,1637097
2004,Palau,Oceania,176037,14269656,14093619
2004,Papua New Guinea,Oceania,84387804,120770691,36382887
2004,French Polynesia,Oceania,38508058,136812945,98304887
2004,Solomon Islands,Oceania,3173674,1904306,-1269368
2004,Tokelau,Oceania,4098344,23715605,19617261
2004,Tonga,Oceania,4345874,9080314,4734440
2004,Tuvalu,Oceania,46202,335286,289084
2004,Vanuatu,Oceania,910016,4600755,3690739
2004,Wallis and Futuna,Oceania,1439,632717,631278
2004,Samoa,Oceania,7298685,25085334,17786649
2004,Argentina,South America,3899501697,3581199149,-318302548
2004,Bolivia,South America,364938120,284464102,-80474018
2004,Brazil,South America,21307939607,12299925685,-9008013922
2004,Chile,South America,5114817705,3651630041,-1463187664
2004,Colombia,South America,7148776719,5188841430,-1959935289
2004,Ecuador,South America,3450571188,1842751106,-1607820082
2004,Falkland Islands,South America,6347226,369747,-5977479
2004,Guyana,South America,125083046,189549820,64466774
2004,Peru,South America,3761744859,2160356839,-1601388020
2004,Paraguay,South America,72951451,353254178,280302727
2004,Suriname,South America,143799331,210148122,66348791
2004,Uruguay,South America,613089889,277139198,-335950691
2004,Venezuela,South America,24784704414,5200026960,-19584677454
2005,Angola,Africa,7751785528,870341777,-6881443751
2005,Burundi,Africa,4617582,13137556,8519974
2005,Benin,Africa,674161,71042134,70367973
2005,Burkina Faso,Africa,1237656,34360750,33123094
2005,Botswana,Africa,249129642,44312913,-204816729
2005,Central African Republic,Africa,5805963,13481143,7675180
2005,Cote d'Ivoire,Africa,1094883525,152398059,-942485466
2005,Cameroon,Africa,132971832,180326516,47354684
2005,Democratic Republic of the Congo,Africa,252432774,59610070,-192822704
2005,Republic of the Congo,Africa,1489978610,98092957,-1391885653
2005,Comoros,Africa,1434505,245890,-1188615
2005,Cape Verde,Africa,7238935,20733074,13494139
2005,Djibouti,Africa,871717,44840424,43968707
2005,Algeria,Africa,10619255106,1385876837,-9233378269
2005,Egypt,Africa,2093035476,3263786708,1170751232
2005,Eritrea,Africa,1089571,28758863,27669292
2005,Ethiopia,Africa,59541191,429705538,370164347
2005,Gabon,Africa,2726919698,135767227,-2591152471
2005,Ghana,Africa,185118301,392513299,207394998
2005,Guinea,Africa,80910501,110188720,29278219
2005,Gambia,Africa,484820,39628844,39144024
2005,Guinea-Bissau,Africa,60550,1791771,1731221
2005,Equatorial Guinea,Africa,1465915482,278685553,-1187229929
2005,Kenya,Africa,267573496,640231688,372658192
2005,Liberia,Africa,90733299,58396980,-32336319
2005,Libya,Africa,1491116123,82304650,-1408811473
2005,Lesotho,Africa,419332391,3755987,-415576404
2005,Morocco,Africa,450903826,635937913,185034087
2005,Madagascar,Africa,232478923,45346104,-187132819
2005,Mali,Africa,3436296,75684083,72247787
2005,Mozambique,Africa,25213274,95600161,70386887
2005,Mauritania,Africa,604352,160078144,159473792
2005,Mauritius,Africa,215310256,67429566,-147880690
2005,Malawi,Africa,101767470,41533962,-60233508
2005,Mayotte,Africa,1049,3979057,3978008
2005,Namibia,Africa,252329518,86227343,-166102175
2005,Niger,Africa,71580057,88681171,17101114
2005,Nigeria,Africa,22130057128,1450810505,-20679246623
2005,Rwanda,Africa,8377041,15884876,7507835
2005,Sudan,Africa,13820311,169060674,155240363
2005,Senegal,Africa,18306100,179342632,161036532
2005,Saint Helena,Africa,3002623,2586134,-416489
2005,Sierra Leone,Africa,9470966,33757055,24286089
2005,Somalia,Africa,369564,8149872,7780308
2005,Sao Tome and Principe,Africa,217015,4989744,4772729
2005,Eswatini,Africa,245623193,22235072,-223388121
2005,Seychelles,Africa,4799048,25543487,20744439
2005,Chad,Africa,1392529206,52222597,-1340306609
2005,Togo,Africa,8725795,30646248,21920453
2005,Tunisia,Africa,195400827,326341828,130941001
2005,Tanzania,Africa,35793917,121063266,85269349
2005,Uganda,Africa,25048357,80515932,55467575
2005,South Africa,Africa,5345728276,4035098750,-1310629526
2005,Zambia,Africa,45239955,46078360,838405
2005,Zimbabwe,Africa,95161285,67468061,-27693224
2005,French South Antarctic Territory,Antarctica,52238,262293,210055
2005,Afghanistan,Asia,24492511,250088450,225595939
2005,United Arab Emirates,Asia,1382163386,6162659622,4780496236
2005,Armenia,Asia,64845135,108043307,43198172
2005,Azerbaijan,Asia,54033463,184390856,130357393
2005,Bangladesh,Asia,3033037341,389338480,-2643698861
2005,Bahrain,Asia,440977306,358391901,-82585405
2005,Brunei,Asia,529852791,39977923,-489874868
2005,Bhutan,Asia,688885,4294586,3605701
2005,Cocos (Keeling) Islands,Asia,484311,994239,509928
2005,China,Asia,1.97688E+11,40267208963,-1.57421E+11
2005,Christmas Island,Asia,298039,1914072,1616033
2005,Cyprus,Asia,32868620,107736280,74867660
2005,Georgia,Asia,188127444,201561435,13433991
2005,Hong Kong,Asia,9063980241,15915688901,6851708660
2005,Indonesia,Asia,11654896016,3562212637,-8092683379
2005,India,Asia,18076631763,7828403730,-10248228033
2005,British Indian Ocean Territory,Asia,462758,789632,326874
2005,Iran,Asia,168417964,140003213,-28414751
2005,Iraq,Asia,8195107103,1322628136,-6872478967
2005,Israel,Asia,17181654930,7886996676,-9294658254
2005,Jordan,Asia,1684162742,692159342,-992003400
2005,Japan,Asia,1.31428E+11,54735891803,-76691758644
2005,Kazakhstan,Asia,1016860092,971322204,-45537888
2005,Kyrgyzstan,Asia,7775605,70203885,62428280
2005,Cambodia,Asia,2609098464,78889897,-2530208567
2005,South Korea,Asia,42874356506,28112328333,-14762028173
2005,Kuwait,Asia,3919762497,1850422261,-2069340236
2005,Laos,Asia,4274805,7776462,3501657
2005,Lebanon,Asia,79327811,607758963,528431152
2005,Sri Lanka,Asia,2075908358,238791783,-1837116575
2005,Macau,Asia,1234700743,156624843,-1078075900
2005,Maldives,Asia,6377125,13657837,7280712
2005,Mongolia,Asia,178643022,42742869,-135900153
2005,Malaysia,Asia,30073494326,10142662104,-19930832222
2005,Nepal,Asia,118510756,20540883,-97969873
2005,Oman,Asia,583984430,642206140,58221710
2005,Pakistan,Asia,3874716923,1381164210,-2493552713
2005,Philippines,Asia,9948011979,6300928977,-3647083002
2005,North Korea,Asia,3289,5757048,5753759
2005,Palestine,Asia,3366188,3952113,585925
2005,Qatar,Asia,436433053,1196478660,760045607
2005,Saudi Arabia,Asia,25598070436,6860731464,-18737338972
2005,Singapore,Asia,16682799437,18675298582,1992499145
2005,Syria,Asia,317347921,219187667,-98160254
2005,Thailand,Asia,18488015049,7748827534,-10739187515
2005,Tajikistan,Asia,232920881,12961160,-219959721
2005,Turkmenistan,Asia,134450563,126789418,-7661145
2005,Timor-Leste,Asia,10377365,4093456,-6283909
2005,Turkey,Asia,5036028774,4626433929,-409594845
2005,Uzbekistan,Asia,95263538,43847276,-51416262
2005,Vietnam,Asia,7128260402,929941181,-6198319221
2005,Chinese Taipei,Asia,32197161231,18841682920,-13355478311
2005,Yemen,Asia,293845063,428391578,134546515
2005,Albania,Europe,37353708,39376537,2022829
2005,Andorra,Europe,597360,10439169,9841809
2005,Austria,Europe,6581839676,3136046131,-3445793545
2005,Belgium,Europe,19338113526,18259203801,-1078909725
2005,Bulgaria,Europe,432038262,414694521,-17343741
2005,Bosnia and Herzegovina,Europe,138353190,114229638,-24123552
2005,Belarus,Europe,266860343,176417827,-90442516
2005,Switzerland,Europe,13788277757,10004802434,-3783475323
2005,Czechia,Europe,2204014667,1409417228,-794597439
2005,Germany,Europe,84571018734,39832237014,-44738781720
2005,Denmark,Europe,5415695419,2103299062,-3312396357
2005,Spain,Europe,8425305033,8047971153,-377333880
2005,Estonia,Europe,390907109,216051766,-174855343
2005,Finland,Europe,3995714375,2359388573,-1636325802
2005,France,Europe,31223748913,21519030124,-9704718789
2005,United Kingdom,Europe,51076066383,35046640528,-16029425855
2005,Gibraltar,Europe,3070148,117132992,114062844
2005,Greece,Europe,940846011,1958572023,1017726012
2005,Croatia,Europe,353761544,388315529,34553985
2005,Hungary,Europe,2209504794,1070478986,-1139025808
2005,Ireland,Europe,26626093964,9193471114,-17432622850
2005,Iceland,Europe,280326634,449073452,168746818
2005,Italy,Europe,29709295050,12324780972,-17384514078
2005,Lithuania,Europe,611168766,502987388,-108181378
2005,Luxembourg,Europe,463794626,757515116,293720490
2005,Latvia,Europe,281437106,164291721,-117145385
2005,Moldova,Europe,59069706,50811547,-8258159
2005,North Macedonia,Europe,47734871,44523378,-3211493
2005,Malta,Europe,499334917,241711788,-257623129
2005,Netherlands,Europe,15618516248,25260703637,9642187389
2005,Norway,Europe,6852004599,2305792794,-4546211805
2005,Poland,Europe,1946460198,1794491331,-151968867
2005,Portugal,Europe,2175893326,1294741140,-881152186
2005,Romania,Europe,1274069995,946165587,-327904408
2005,Russia,Europe,7943366307,4482238752,-3461127555
2005,San Marino,Europe,1335011,4530228,3195217
2005,Slovakia,Europe,1432537114,299047039,-1133490075
2005,Slovenia,Europe,452783812,353515520,-99268292
2005,Sweden,Europe,13722367788,3763695667,-9958672121
2005,Ukraine,Europe,1048918991,669021072,-379897919
2005,Yugoslavia,Europe,58985467,109931511,50946044
2005,Aruba,North America,2777301274,572506052,-2204795222
2005,Anguilla,North America,2294454,27948811,25654357
2005,Netherlands Antilles,North America,738889343,961908340,223018997
2005,Antigua and Barbuda,North America,10111080,220354260,210243180
2005,Bahamas,North America,533338020,1684342666,1151004646
2005,Belize,North America,133549401,211185661,77636260
2005,Bermuda,North America,5081005,375919043,370838038
2005,Barbados,North America,48578834,537811050,489232216
2005,Canada,North America,2.85558E+11,1.93375E+11,-92182954901
2005,Costa Rica,North America,3288697558,3871915452,583217894
2005,Cuba,North America,559475,450540864,449981389
2005,Cayman Islands,North America,5102736,468903459,463800723
2005,Dominica,North America,2922351,79954764,77032413
2005,Dominican Republic,North America,4873816452,4693308800,-180507652
2005,Grenada,North America,6614021,117313822,110699801
2005,Greenland,North America,6514287,5647325,-866962
2005,Guatemala,North America,2424437555,3519711648,1095274093
2005,Honduras,North America,2479248043,3071314031,592065988
2005,Haiti,North America,453387846,609736167,156348321
2005,Jamaica,North America,401914541,1797073667,1395159126
2005,Saint Kitts and Nevis,North America,47753330,129280568,81527238
2005,Saint Lucia,North America,15727381,195440179,179712798
2005,Mexico,North America,1.79347E+11,1.16347E+11,-63000698775
2005,Montserrat,North America,1231357,15923795,14692438
2005,Nicaragua,North America,807646660,618282167,-189364493
2005,Panama,North America,444575238,1963676784,1519101546
2005,El Salvador,North America,1925603445,2290527507,364924062
2005,Saint Pierre and Miquelon,North America,1092309,889900,-202409
2005,Turks and Caicos Islands,North America,9074440,139848072,130773632
2005,Trinidad and Tobago,North America,5935734038,1580476604,-4355257434
2005,Saint Vincent and the Grenadines,North America,16588627,77307456,60718829
2005,British Virgin Islands,North America,9300944,92321452,83020508
2005,Australia,Oceania,7032128687,16615803791,9583675104
2005,Cook Islands,Oceania,2111851,1837297,-274554
2005,Fiji,Oceania,189038455,64166037,-124872418
2005,Micronesia,Oceania,1623621,46814627,45191006
2005,Kiribati,Oceania,1171467,2570920,1399453
2005,Marshall Islands,Oceania,14101372,17854591,3753219
2005,New Caledonia,Oceania,28053109,61982299,33929190
2005,Norfolk Island,Oceania,179956,354246,174290
2005,Niue,Oceania,143893,579504,435611
2005,Nauru,Oceania,132604,1561337,1428733
2005,New Zealand,Oceania,3168576682,2649749350,-518827332
2005,Pitcairn Islands,Oceania,1068268,431153,-637115
2005,Palau,Oceania,612641,10330213,9717572
2005,Papua New Guinea,Oceania,57077843,47114092,-9963751
2005,French Polynesia,Oceania,46523477,165171173,118647696
2005,Solomon Islands,Oceania,2118818,1621485,-497333
2005,Tokelau,Oceania,5861545,75131472,69269927
2005,Tonga,Oceania,4416081,11146236,6730155
2005,Tuvalu,Oceania,59998,54097,-5901
2005,Vanuatu,Oceania,1078363,5251341,4172978
2005,Wallis and Futuna,Oceania,26182,1026372,1000190
2005,Samoa,Oceania,7718357,28755499,21037142
2005,Argentina,South America,4730899221,4557519875,-173379346
2005,Bolivia,South America,418312320,327192315,-91120005
2005,Brazil,South America,24065245821,13489263411,-10575982410
2005,Chile,South America,6823097275,5208025516,-1615071759
2005,Colombia,South America,9230301219,6374944905,-2855356314
2005,Ecuador,South America,5191571537,2307809123,-2883762414
2005,Falkland Islands,South America,8841413,8621626,-219787
2005,Guyana,South America,109265561,224965000,115699439
2005,Peru,South America,5319943681,2450266128,-2869677553
2005,Paraguay,South America,76842171,588288669,511446498
2005,Suriname,South America,164624610,250519320,85894710
2005,Uruguay,South America,816879661,312502310,-504377351
2005,Venezuela,South America,27291079687,7273616485,-20017463202
2006,Angola,Africa,10651053450,1536064956,-9114988494
2006,Burundi,Africa,2016118,14830573,12814455
2006,Benin,Africa,756673,117653234,116896561
2006,Burkina Faso,Africa,953440,16763125,15809685
2006,Botswana,Africa,160010326,27872222,-132138104
2006,Central African Republic,Africa,4297218,23269558,18972340
2006,Cote d'Ivoire,Africa,787041644,176021041,-611020603
2006,Cameroon,Africa,258242838,144912402,-113330436
2006,Democratic Republic of the Congo,Africa,84365127,66740803,-17624324
2006,Republic of the Congo,Africa,2792040795,131555014,-2660485781
2006,Comoros,Africa,1572350,104991,-1467359
2006,Cape Verde,Africa,1401791,16082826,14681035
2006,Djibouti,Africa,820899,43610513,42789614
2006,Algeria,Africa,15054864289,1298655787,-13756208502
2006,Egypt,Africa,2587352967,3889787888,1302434921
2006,Eritrea,Africa,552390,8495787,7943397
2006,Ethiopia,Africa,44792266,166416741,121624475
2006,Gabon,Africa,1630826746,161156239,-1469670507
2006,Ghana,Africa,197730277,353130801,155400524
2006,Guinea,Africa,114597374,68614165,-45983209
2006,Gambia,Africa,524469,43827398,43302929
2006,Guinea-Bissau,Africa,481010,3509365,3028355
2006,Equatorial Guinea,Africa,1594907611,542737868,-1052169743
2006,Kenya,Africa,336067410,506444886,170377476
2006,Liberia,Africa,134560395,59097612,-75462783
2006,Libya,Africa,2323135762,430376491,-1892759271
2006,Lesotho,Africa,427609783,3920215,-423689568
2006,Morocco,Africa,449435415,974219812,524784397
2006,Madagascar,Africa,209242488,79749593,-129492895
2006,Mali,Africa,9584743,93332739,83747996
2006,Mozambique,Africa,18949158,97047453,78098295
2006,Mauritania,Africa,47293004,117868389,70575385
2006,Mauritius,Africa,218201648,71182433,-147019215
2006,Malawi,Africa,77594182,48132126,-29462056
2006,Mayotte,Africa,53537,4277448,4223911
2006,Namibia,Africa,154397259,91464395,-62932864
2006,Niger,Africa,128797661,152932051,24134390
2006,Nigeria,Africa,28871002417,2812956027,-26058046390
2006,Rwanda,Africa,11171344,20332021,9160677
2006,Sudan,Africa,9476247,120761613,111285366
2006,Senegal,Africa,23817701,139295337,115477636
2006,Saint Helena,Africa,1544253,1714371,170118
2006,Sierra Leone,Africa,39203217,35845570,-3357647
2006,Somalia,Africa,307287,18348970,18041683
2006,Sao Tome and Principe,Africa,200400,4067469,3867069
2006,Eswatini,Africa,183508922,20720597,-162788325
2006,Seychelles,Africa,7505587,14508090,7002503
2006,Chad,Africa,1762245826,58198953,-1704046873
2006,Togo,Africa,3482573,107747403,104264830
2006,Tunisia,Africa,454345315,452731257,-1614058
2006,Tanzania,Africa,38660172,174194283,135534111
2006,Uganda,Africa,22989494,88592180,65602686
2006,South Africa,Africa,6620801585,4807572437,-1813229148
2006,Zambia,Africa,30482850,66558620,36075770
2006,Zimbabwe,Africa,233887782,226375824,-7511958
2006,French South Antarctic Territory,Antarctica,97865,127636,29771
2006,Afghanistan,Asia,13414555,405242048,391827493
2006,United Arab Emirates,Asia,1202826502,11753506249,10550679747
2006,Armenia,Asia,70374690,107626803,37252113
2006,Azerbaijan,Asia,133266143,269189573,135923430
2006,Bangladesh,Asia,3613527201,471136682,-3142390519
2006,Bahrain,Asia,543446170,406246723,-137199447
2006,Brunei,Asia,543729222,117008771,-426720451
2006,Bhutan,Asia,930928,3172753,2241825
2006,Cocos (Keeling) Islands,Asia,1484541,718406,-766135
2006,China,Asia,2.36916E+11,53460681683,-1.83455E+11
2006,Christmas Island,Asia,327914,1431867,1103953
2006,Cyprus,Asia,43624516,254599565,210975049
2006,Georgia,Asia,105667644,224036256,118368612
2006,Hong Kong,Asia,8960338018,17251643119,8291305101
2006,Indonesia,Asia,13034418937,3769378485,-9265040452
2006,India,Asia,20529273752,10213113409,-10316160343
2006,British Indian Ocean Territory,Asia,665342,251407,-413935
2006,Iran,Asia,153542072,84931007,-68611065
2006,Iraq,Asia,10371188177,1458425796,-8912762381
2006,Israel,Asia,19360483612,8452404110,-10908079502
2006,Jordan,Asia,1432761005,699279017,-733481988
2006,Japan,Asia,1.41514E+11,60920024733,-80593728793
2006,Kazakhstan,Asia,924149276,960268660,36119384
2006,Kyrgyzstan,Asia,10067147,106619165,96552018
2006,Cambodia,Asia,3100805051,76268396,-3024536655
2006,South Korea,Asia,44422798500,32342850055,-12079948445
2006,Kuwait,Asia,3665244176,2375953918,-1289290258
2006,Laos,Asia,9309132,6830285,-2478847
2006,Lebanon,Asia,75137381,1072485075,997347694
2006,Sri Lanka,Asia,2174179429,272287459,-1901891970
2006,Macau,Asia,1161807805,290152870,-871654935
2006,Maldives,Asia,1628745,32782939,31154194
2006,Mongolia,Asia,150261849,44691113,-105570736
2006,Malaysia,Asia,33972396972,12269544061,-21702852911
2006,Nepal,Asia,107053492,14740999,-92312493
2006,Oman,Asia,840231322,909923348,69692026
2006,Pakistan,Asia,4278702162,2174223559,-2104478603
2006,Philippines,Asia,9383952741,7121665421,-2262287320
2006,Palestine,Asia,4319540,2263119,-2056421
2006,Qatar,Asia,204468540,1574573540,1370105000
2006,Saudi Arabia,Asia,29192298684,7935780359,-21256518325
2006,Singapore,Asia,18126487131,24573063319,6446576188
2006,Syria,Asia,231622735,264512045,32889310
2006,Thailand,Asia,21158420223,7715590097,-13442830126
2006,Tajikistan,Asia,58093785,11945658,-46148127
2006,Turkmenistan,Asia,76382978,107571988,31189010
2006,Turkey,Asia,5255410593,6097838136,842427543
2006,Uzbekistan,Asia,152785302,29636005,-123149297
2006,Vietnam,Asia,9023587938,1216138082,-7807449856
2006,Chinese Taipei,Asia,35871871973,21696885889,-14174986084
2006,Yemen,Asia,497682265,415972810,-81709455
2006,Albania,Europe,22679475,42436848,19757373
2006,Andorra,Europe,2980867,14571735,11590868
2006,Austria,Europe,7860650648,3639261331,-4221389317
2006,Belgium,Europe,17869201440,21089730542,3220529102
2006,Bulgaria,Europe,516742168,445264161,-71478007
2006,Bosnia and Herzegovina,Europe,140307281,169160415,28853134
2006,Belarus,Europe,527972649,195102006,-332870643
2006,Switzerland,Europe,15548534704,12767517724,-2781016980
2006,Czechia,Europe,2312746624,1574112618,-738634006
2006,Germany,Europe,95091345312,49354633766,-45736711546
2006,Denmark,Europe,5832059927,2390095545,-3441964382
2006,Spain,Europe,9835567823,9209234716,-626333107
2006,Estonia,Europe,655786715,270634421,-385152294
2006,Finland,Europe,5385853165,2707023622,-2678829543
2006,France,Europe,33564287324,27889021656,-5675265668
2006,United Kingdom,Europe,53589067099,44231614656,-9357452443
2006,Gibraltar,Europe,780361,236273764,235493403
2006,Greece,Europe,993202492,1344040069,350837577
2006,Croatia,Europe,343907273,361996392,18089119
2006,Hungary,Europe,2279665317,1270955973,-1008709344
2006,Ireland,Europe,25951412119,8360627398,-17590784721
2006,Iceland,Europe,401771850,787589244,385817394
2006,Italy,Europe,31071229291,12648283549,-18422945742
2006,Lithuania,Europe,616483698,571011926,-45471772
2006,Luxembourg,Europe,591412366,830140773,238728407
2006,Latvia,Europe,165714454,180975346,15260892
2006,Moldova,Europe,43779429,39641892,-4137537
2006,North Macedonia,Europe,26855739,42734009,15878270
2006,Malta,Europe,304898306,206762876,-98135430
2006,Montenegro,Europe,609425,34061121,33451696
2006,Netherlands,Europe,18877200943,30709605696,11832404753
2006,Norway,Europe,7067734074,2893003706,-4174730368
2006,Poland,Europe,2243970298,2377737097,133766799
2006,Portugal,Europe,2755360177,1202184238,-1553175939
2006,Romania,Europe,1031445111,1019210807,-12234304
2006,Russia,Europe,9328292627,5275449113,-4052843514
2006,San Marino,Europe,3145656,8689441,5543785
2006,Serbia,Europe,81965364,225393496,143428132
2006,Slovakia,Europe,1604481484,674430845,-930050639
2006,Slovenia,Europe,563956184,414305539,-149650645
2006,Sweden,Europe,13920704389,4377342108,-9543362281
2006,Ukraine,Europe,1460143516,906594823,-553548693
2006,Aruba,North America,2661808805,478520765,-2183288040
2006,Anguilla,North America,4772347,63979844,59207497
2006,Netherlands Antilles,North America,929958603,1242119903,312161300
2006,Antigua and Barbuda,North America,1287270,235382076,234094806
2006,Bahamas,North America,397917887,2181190369,1783272482
2006,Belize,North America,125123068,227498617,102375549
2006,Bermuda,North America,5322084,562937832,557615748
2006,Barbados,North America,89933688,552725858,462792170
2006,Canada,North America,2.99565E+11,2.11321E+11,-88243599607
2006,Costa Rica,North America,3515553447,4489321375,973767928
2006,Cuba,North America,366899,484138033,483771134
2006,Cayman Islands,North America,6883300,471304908,464421608
2006,Dominica,North America,3078605,88117247,85038642
2006,Dominican Republic,North America,5011659587,5334142286,322482699
2006,Grenada,North America,7356460,104304226,96947766
2006,Greenland,North America,3966629,16489252,12522623
2006,Guatemala,North America,1451342736,3882770233,2431427497
2006,Honduras,North America,3191882501,3398628597,206746096
2006,Haiti,North America,491755626,689305468,197549842
2006,Jamaica,North America,620016044,2001075383,1381059339
2006,Saint Kitts and Nevis,North America,52027762,165443702,113415940
2006,Saint Lucia,North America,21517377,208338336,186820959
2006,Mexico,North America,2.08112E+11,1.29712E+11,-78399652689
2006,Montserrat,North America,562204,22971823,22409619
2006,Nicaragua,North America,1005459631,715469787,-289989844
2006,Panama,North America,480898889,2569528954,2088630065
2006,El Salvador,North America,2050683208,2618866931,568183723
2006,Saint Pierre and Miquelon,North America,1159693,409793,-749900
2006,Turks and Caicos Islands,North America,8224034,213773667,205549633
2006,Trinidad and Tobago,North America,8309187075,1744621598,-6564565477
2006,Saint Vincent and the Grenadines,North America,2139930,96802554,94662624
2006,British Virgin Islands,North America,22842529,201714466,178871937
2006,Australia,Oceania,7844806090,18673439083,10828632993
2006,Cook Islands,Oceania,1947560,2659230,711670
2006,Fiji,Oceania,178482150,49947631,-128534519
2006,Micronesia,Oceania,1657834,54922022,53264188
2006,Kiribati,Oceania,1162317,3016055,1853738
2006,Marshall Islands,Oceania,10073018,15189940,5116922
2006,New Caledonia,Oceania,34450061,66245556,31795495
2006,Norfolk Island,Oceania,127338,1759506,1632168
2006,Niue,Oceania,71876,2441543,2369667
2006,Nauru,Oceania,254290,3602064,3347774
2006,New Zealand,Oceania,3033776265,2948304892,-85471373
2006,Pitcairn Islands,Oceania,109320,1311443,1202123
2006,Palau,Oceania,976492,9210946,8234454
2006,Papua New Guinea,Oceania,81005384,40933080,-40072304
2006,French Polynesia,Oceania,36978022,158399450,121421428
2006,Solomon Islands,Oceania,2661721,3071399,409678
2006,Tokelau,Oceania,5210700,41958942,36748242
2006,Tonga,Oceania,4600088,12809948,8209860
2006,Tuvalu,Oceania,23745,72341,48596
2006,Vanuatu,Oceania,1414361,7024501,5610140
2006,Wallis and Futuna,Oceania,11878,1318574,1306696
2006,Samoa,Oceania,4700699,32293338,27592639
2006,Argentina,South America,4205022154,4504274066,299251912
2006,Bolivia,South America,422536534,306777390,-115759144
2006,Brazil,South America,25039539609,16857200535,-8182339074
2006,Chile,South America,9571810051,6522973477,-3048836574
2006,Colombia,South America,9924605393,7230351693,-2694253700
2006,Ecuador,South America,6904840288,2851962558,-4052877730
2006,Falkland Islands,South America,11630730,1238812,-10391918
2006,Guyana,South America,116050116,220082384,104032268
2006,Peru,South America,5840477373,2756965344,-3083512029
2006,Paraguay,South America,93762066,638744461,544982395
2006,Suriname,South America,160494399,255686725,95192326
2006,Uruguay,South America,556971122,401769743,-155201379
2006,Venezuela,South America,32375681602,9208205405,-23167476197
2007,Angola,Africa,12111061660,1183584540,-10927477120
2007,Burundi,Africa,1606523,9186124,7579601
2007,Benin,Africa,5083458,332624370,327540912
2007,Burkina Faso,Africa,1854931,99620490,97765559
2007,Botswana,Africa,112963131,52089792,-60873339
2007,Central African Republic,Africa,3074331,20798934,17724603
2007,Cote d'Ivoire,Africa,592071834,194464412,-397607422
2007,Cameroon,Africa,267206283,249707432,-17498851
2007,Democratic Republic of the Congo,Africa,202560568,105880649,-96679919
2007,Republic of the Congo,Africa,845864292,145018125,-700846167
2007,Comoros,Africa,555837,355036,-200801
2007,Cape Verde,Africa,2068627,11965917,9897290
2007,Djibouti,Africa,1064806,54851489,53786683
2007,Algeria,Africa,17986680645,1979057369,-16007623276
2007,Egypt,Africa,2464143651,5225376139,2761232488
2007,Eritrea,Africa,267805,5811743,5543938
2007,Ethiopia,Africa,94313516,244294505,149980989
2007,Gabon,Africa,2224924166,483740168,-1741183998
2007,Ghana,Africa,207430605,534245006,326814401
2007,Guinea,Africa,128245153,79884670,-48360483
2007,Gambia,Africa,432153,46918586,46486433
2007,Guinea-Bissau,Africa,41420,2172965,2131545
2007,Equatorial Guinea,Africa,1634929685,232140573,-1402789112
2007,Kenya,Africa,308426520,640375834,331949314
2007,Liberia,Africa,111545228,66171913,-45373315
2007,Libya,Africa,2387743961,624869020,-1762874941
2007,Lesotho,Africa,454978591,7338303,-447640288
2007,Morocco,Africa,568721746,1735861514,1167139768
2007,Madagascar,Africa,270658523,91237810,-179420713
2007,Mali,Africa,12805103,76438291,63633188
2007,Mozambique,Africa,6963274,136649739,129686465
2007,Mauritania,Africa,608788,128388551,127779763
2007,Mauritius,Africa,168681969,88736802,-79945167
2007,Malawi,Africa,58266950,64320008,6053058
2007,Mayotte,Africa,309991,6602000,6292009
2007,Namibia,Africa,193332204,100095244,-93236960
2007,Niger,Africa,36318163,109121179,72803016
2007,Nigeria,Africa,33527810557,3470939188,-30056871369
2007,Rwanda,Africa,19901557,32089522,12187965
2007,Sudan,Africa,8348728,124485557,116136829
2007,Senegal,Africa,23298188,175250342,151952154
2007,Saint Helena,Africa,5262074,3208470,-2053604
2007,Sierra Leone,Africa,53969361,51669297,-2300064
2007,Somalia,Africa,182693,19803371,19620678
2007,Sao Tome and Principe,Africa,399241,8242466,7843225
2007,Eswatini,Africa,153646050,40848521,-112797529
2007,Seychelles,Africa,9965859,13840023,3874164
2007,Chad,Africa,1964795880,68509408,-1896286472
2007,Togo,Africa,6673990,291361166,284687176
2007,Tunisia,Africa,401733810,559355325,157621515
2007,Tanzania,Africa,77567259,227407499,149840240
2007,Uganda,Africa,27084570,109936266,82851696
2007,South Africa,Africa,8007556168,5928043451,-2079512717
2007,Zambia,Africa,74896429,73979668,-916761
2007,Zimbabwe,Africa,122283430,154291048,32007618
2007,French South Antarctic Territory,Antarctica,506281,386605,-119676
2007,Afghanistan,Asia,10048893,478433718,468384825
2007,United Arab Emirates,Asia,1033330803,9457201786,8423870983
2007,Armenia,Asia,53282372,141405793,88123421
2007,Azerbaijan,Asia,424506068,258147006,-166359062
2007,Bangladesh,Asia,3713877770,592117216,-3121760554
2007,Bahrain,Asia,498626152,497811041,-815111
2007,Brunei,Asia,417324964,229611806,-187713158
2007,Bhutan,Asia,746726,4488306,3741580
2007,Cocos (Keeling) Islands,Asia,875184,1168403,293219
2007,China,Asia,2.70099E+11,62817460343,-2.07281E+11
2007,Christmas Island,Asia,3117008,2415550,-701458
2007,Cyprus,Asia,14009268,168469156,154459888
2007,Georgia,Asia,210554237,305890402,95336165
2007,Hong Kong,Asia,8286672564,19375478328,11088805764
2007,Indonesia,Asia,14160963809,4535313158,-9625650651
2007,India,Asia,22429582194,14137592384,-8291989810
2007,British Indian Ocean Territory,Asia,44141,957435,913294
2007,Iran,Asia,174306222,145521763,-28784459
2007,Iraq,Asia,10036853213,1539760618,-8497092595
2007,Israel,Asia,20713972801,12457191084,-8256781717
2007,Jordan,Asia,1538589679,866595368,-671994311
2007,Japan,Asia,1.40942E+11,63958687710,-76983728615
2007,Kazakhstan,Asia,854925262,1340581279,485656017
2007,Kyrgyzstan,Asia,4644026,59579417,54935391
2007,Cambodia,Asia,3336667045,144156157,-3192510888
2007,South Korea,Asia,46818482258,34466223176,-12352259082
2007,Kuwait,Asia,3807976063,2692667748,-1115308315
2007,Laos,Asia,20584579,13055648,-7528931
2007,Lebanon,Asia,94276131,1209680532,1115404401
2007,Sri Lanka,Asia,2043510510,300041385,-1743469125
2007,Macau,Asia,1066354069,303925808,-762428261
2007,Maldives,Asia,3139250,31987911,28848661
2007,Mongolia,Asia,91172836,52505474,-38667362
2007,Malaysia,Asia,31593090637,12298562419,-19294528218
2007,Nepal,Asia,95590977,26061617,-69529360
2007,Oman,Asia,1002124038,1082151618,80027580
2007,Pakistan,Asia,3890862887,2235644125,-1655218762
2007,Philippines,Asia,10286345320,7317055530,-2969289790
2007,Palestine,Asia,6233221,41389005,35155784
2007,Qatar,Asia,366921083,3035156366,2668235283
2007,Saudi Arabia,Asia,33098668466,9783249038,-23315419428
2007,Singapore,Asia,21069578071,27412145045,6342566974
2007,Syria,Asia,270594046,385035475,114441429
2007,Thailand,Asia,20986525129,8692982815,-12293542314
2007,Tajikistan,Asia,314913,24594283,24279370
2007,Turkmenistan,Asia,214557113,183519849,-31037264
2007,Turkey,Asia,4416895682,7371990512,2955094830
2007,Uzbekistan,Asia,165133118,60042907,-105090211
2007,Vietnam,Asia,11748246369,2023891966,-9724354403
2007,Chinese Taipei,Asia,36144046930,25776211193,-10367835737
2007,Yemen,Asia,300587334,1078942136,778354802
2007,Albania,Europe,13306092,58712592,45406500
2007,Andorra,Europe,513743,22750062,22236319
2007,Austria,Europe,8326213370,3802566739,-4523646631
2007,Belgium,Europe,20121581229,25208938260,5087357031
2007,Bulgaria,Europe,476678781,514242106,37563325
2007,Bosnia and Herzegovina,Europe,116540207,176039054,59498847
2007,Belarus,Europe,358744434,266938961,-91805473
2007,Switzerland,Europe,15958619131,14435956585,-1522662546
2007,Czechia,Europe,2457284060,1811577265,-645706795
2007,Germany,Europe,98118701740,51812679065,-46306022675
2007,Denmark,Europe,6201683423,3006623061,-3195060362
2007,Spain,Europe,10502924316,11388456041,885531725
2007,Estonia,Europe,463195048,321420518,-141774530
2007,Finland,Europe,5716826377,2954263440,-2762562937
2007,France,Europe,34693805224,29326222457,-5367582767
2007,United Kingdom,Europe,57954838010,49254408662,-8700429348
2007,Gibraltar,Europe,3121355,494954625,491833270
2007,Greece,Europe,1302168402,2169166199,866997797
2007,Croatia,Europe,385799495,440191956,54392461
2007,Hungary,Europe,2386139027,1458520445,-927618582
2007,Ireland,Europe,27060620921,9003456327,-18057164594
2007,Iceland,Europe,361422609,842004004,480581395
2007,Italy,Europe,33017856105,14346140254,-18671715851
2007,Lithuania,Europe,471711484,702500420,230788936
2007,Luxembourg,Europe,485148943,990134382,504985439
2007,Latvia,Europe,185189132,280225927,95036795
2007,Moldova,Europe,31783932,76210505,44426573
2007,North Macedonia,Europe,63298312,73159083,9860771
2007,Malta,Europe,284157613,294306577,10148964
2007,Montenegro,Europe,6183989,65652544,59468555
2007,Netherlands,Europe,20905378055,31996572642,11091194587
2007,Norway,Europe,8361633642,3513695164,-4847938478
2007,Poland,Europe,2134639230,3270311460,1135672230
2007,Portugal,Europe,2687889605,1765890839,-921998766
2007,Romania,Europe,985482585,862260089,-123222496
2007,Russia,Europe,9943271415,7913736638,-2029534777
2007,San Marino,Europe,1534019,13714336,12180317
2007,Serbia,Europe,87124052,274675594,187551542
2007,Slovakia,Europe,1702845072,825705842,-877139230
2007,Slovenia,Europe,507239036,574006858,66767822
2007,Sweden,Europe,12738234098,4553500887,-8184733211
2007,Ukraine,Europe,1167275146,1479318969,312043823
2007,Aruba,North America,2830525640,485884091,-2344641549
2007,Anguilla,North America,6027656,110639248,104611592
2007,Netherlands Antilles,North America,630328745,1814542984,1184214239
2007,Antigua and Barbuda,North America,24190835,294854917,270664082
2007,Bahamas,North America,517557266,2361697203,1844139937
2007,Belize,North America,111150974,239088513,127937539
2007,Bermuda,North America,8049823,591031815,582981992
2007,Barbados,North America,49624052,554895726,505271674
2007,Canada,North America,3.14216E+11,2.25558E+11,-88658096481
2007,Costa Rica,North America,3572180457,4859549265,1287368808
2007,Cuba,North America,202701,442562528,442359827
2007,Cayman Islands,North America,6536899,478433003,471896104
2007,Dominica,North America,1596017,101802227,100206210
2007,Dominican Republic,North America,4504326373,6294506438,1790180065
2007,Grenada,North America,11360022,111953401,100593379
2007,Greenland,North America,10120383,5449713,-4670670
2007,Guatemala,North America,2777495443,4557540708,1780045265
2007,Honduras,North America,3180636263,4170822383,990186120
2007,Haiti,North America,493994717,581840749,87846032
2007,Jamaica,North America,952712007,2387685739,1434973732
2007,Saint Kitts and Nevis,North America,52307802,145458447,93150645
2007,Saint Lucia,North America,16065721,212929056,196863335
2007,Mexico,North America,2.14247E+11,1.34675E+11,-79571982135
2007,Montserrat,North America,485930,13575476,13089546
2007,Nicaragua,North America,784845521,843905432,59059911
2007,Panama,North America,555674548,3698910028,3143235480
2007,El Salvador,North America,2202077960,2920959244,718881284
2007,Saint Pierre and Miquelon,North America,1585573,191521,-1394052
2007,Turks and Caicos Islands,North America,8031466,229017804,220986338
2007,Trinidad and Tobago,North America,8016980579,1850813497,-6166167082
2007,Saint Vincent and the Grenadines,North America,2329414,116542070,114212656
2007,British Virgin Islands,North America,37062473,158278134,121215661
2007,Australia,Oceania,8557724047,19696961819,11139237772
2007,Cook Islands,Oceania,1617479,2490641,873162
2007,Fiji,Oceania,190877947,53189954,-137687993
2007,Micronesia,Oceania,8296817,65735414,57438597
2007,Kiribati,Oceania,1128080,3239165,2111085
2007,Marshall Islands,Oceania,10990866,20508819,9517953
2007,New Caledonia,Oceania,49456354,71124581,21668227
2007,Norfolk Island,Oceania,400955,1383138,982183
2007,Niue,Oceania,517478,1597936,1080458
2007,Nauru,Oceania,290994,7750060,7459066
2007,New Zealand,Oceania,3244403186,2822163795,-422239391
2007,Pitcairn Islands,Oceania,81695,1792435,1710740
2007,Palau,Oceania,596951,34299980,33703029
2007,Papua New Guinea,Oceania,99513876,61186815,-38327061
2007,French Polynesia,Oceania,21873830,162357993,140484163
2007,Solomon Islands,Oceania,1502725,2138130,635405
2007,Tokelau,Oceania,7868003,49674187,41806184
2007,Tonga,Oceania,5116975,16240321,11123346
2007,Tuvalu,Oceania,32817,48752,15935
2007,Vanuatu,Oceania,1102053,21312312,20210259
2007,Wallis and Futuna,Oceania,34356,200383,166027
2007,Samoa,Oceania,5583135,32214710,26631575
2007,Argentina,South America,4416666867,5738722335,1322055468
2007,Bolivia,South America,421637869,379943884,-41693985
2007,Brazil,South America,25349585978,21392903594,-3956682384
2007,Chile,South America,8824302177,8019204803,-805097374
2007,Colombia,South America,11068624473,8719776710,-2348847763
2007,Ecuador,South America,6080635852,2903895726,-3176740126
2007,Falkland Islands,South America,4642519,887573,-3754946
2007,Guyana,South America,132878512,237903123,105024611
2007,Peru,South America,5729276682,3759598666,-1969678016
2007,Paraguay,South America,77984883,674633668,596648785
2007,Suriname,South America,130161379,304033261,173871882
2007,Uruguay,South America,523303954,519602181,-3701773
2007,Venezuela,South America,36991293588,10041795303,-26949498285
2008,Angola,Africa,17241234495,2091020550,-15150213945
2008,Burundi,Africa,3000516,9049570,6049054
2008,Benin,Africa,15260544,838707621,823447077
2008,Burkina Faso,Africa,11978160,63716713,51738553
2008,Botswana,Africa,110895475,70666718,-40228757
2008,Central African Republic,Africa,8775036,23128170,14353134
2008,Cote d'Ivoire,Africa,995476890,273176899,-722299991
2008,Cameroon,Africa,576110067,265041575,-311068492
2008,Democratic Republic of the Congo,Africa,257423422,122964715,-134458707
2008,Republic of the Congo,Africa,5014009882,209572785,-4804437097
2008,Comoros,Africa,968924,465271,-503653
2008,Cape Verde,Africa,447686,13455397,13007711
2008,Djibouti,Africa,1352409,136823042,135470633
2008,Algeria,Africa,18955862367,1537067864,-17418794503
2008,Egypt,Africa,2225857102,6607629229,4381772127
2008,Eritrea,Africa,111572,14280961,14169389
2008,Ethiopia,Africa,91522789,422588649,331065860
2008,Gabon,Africa,2114983019,275772528,-1839210491
2008,Ghana,Africa,244013051,713459048,469445997
2008,Guinea,Africa,150389757,100752814,-49636943
2008,Gambia,Africa,940631,49019318,48078687
2008,Guinea-Bissau,Africa,167903,1888729,1720826
2008,Equatorial Guinea,Africa,3083511557,181850852,-2901660705
2008,Kenya,Africa,400076404,556862101,156785697
2008,Liberia,Africa,139644123,140458470,814347
2008,Libya,Africa,2789171297,787389093,-2001782204
2008,Lesotho,Africa,357734706,8583660,-349151046
2008,Morocco,Africa,942408703,1986436206,1044027503
2008,Madagascar,Africa,375667662,181947795,-193719867
2008,Mali,Africa,20003352,151503733,131500381
2008,Mozambique,Africa,19273804,234209127,214935323
2008,Mauritania,Africa,43122211,128279503,85157292
2008,Mauritius,Africa,153170600,111172540,-41998060
2008,Malawi,Africa,62373981,59849735,-2524246
2008,Mayotte,Africa,17459,7430517,7413058
2008,Namibia,Africa,309845211,252405917,-57439294
2008,Niger,Africa,142523138,114041173,-28481965
2008,Nigeria,Africa,39283626700,4364451289,-34919175411
2008,Rwanda,Africa,17822478,44571570,26749092
2008,Sudan,Africa,5125560,187964780,182839220
2008,Senegal,Africa,14882761,163446219,148563458
2008,Saint Helena,Africa,9972305,1989149,-7983156
2008,Sierra Leone,Africa,52492117,55239238,2747121
2008,Somalia,Africa,168944,62053125,61884181
2008,Sao Tome and Principe,Africa,137259,3247458,3110199
2008,Eswatini,Africa,143315888,15898254,-127417634
2008,Seychelles,Africa,6136440,27962350,21825910
2008,Chad,Africa,3054486075,60813510,-2993672565
2008,Togo,Africa,11500656,120595909,109095253
2008,Tunisia,Africa,568301101,651223142,82922041
2008,Tanzania,Africa,72636791,271601319,198964528
2008,Uganda,Africa,26019862,126159603,100139741
2008,South Africa,Africa,8426647716,6885146241,-1541501475
2008,Zambia,Africa,76422172,83886743,7464571
2008,Zimbabwe,Africa,121329531,113801457,-7528074
2008,French South Antarctic Territory,Antarctica,37170,4238926,4201756
2008,Afghanistan,Asia,26575575,471211696,444636121
2008,United Arab Emirates,Asia,1339127556,15471387763,14132260207
2008,Armenia,Asia,61029486,176164376,115134890
2008,Azerbaijan,Asia,5936982478,291902857,-5645079621
2008,Bangladesh,Asia,4152570539,557699315,-3594871224
2008,Bahrain,Asia,488035818,836755148,348719330
2008,Brunei,Asia,116991448,241439320,124447872
2008,Bhutan,Asia,556101,3582899,3026798
2008,Cocos (Keeling) Islands,Asia,1167710,930025,-237685
2008,China,Asia,2.88356E+11,68650569963,-2.19705E+11
2008,Christmas Island,Asia,566317,12916740,12350423
2008,Cyprus,Asia,16900185,222261360,205361175
2008,Georgia,Asia,162059077,442301101,280242024
2008,Hong Kong,Asia,6063187795,20931859821,14868672026
2008,Indonesia,Asia,15747691768,6551773202,-9195918566
2008,India,Asia,23049091722,19253794080,-3795297642
2008,British Indian Ocean Territory,Asia,389724,595953,206229
2008,Iran,Asia,103226171,683175698,579949527
2008,Iraq,Asia,20119024493,2068915987,-18050108506
2008,Israel,Asia,21782182020,13708458122,-8073723898
2008,Jordan,Asia,1057502908,959755774,-97747134
2008,Japan,Asia,1.33488E+11,68295886795,-65192205153
2008,Kazakhstan,Asia,1268037234,1557556665,289519431
2008,Kyrgyzstan,Asia,2858765,92872054,90013289
2008,Cambodia,Asia,3160346087,263511796,-2896834291
2008,South Korea,Asia,47620745626,35478115374,-12142630252
2008,Kuwait,Asia,6650722196,2809402014,-3841320182
2008,Laos,Asia,43612683,17914825,-25697858
2008,Lebanon,Asia,78923469,1720255255,1641331786
2008,Sri Lanka,Asia,1916173082,354125088,-1562047994
2008,Macau,Asia,839803047,347625376,-492177671
2008,Maldives,Asia,4131338,40280084,36148746
2008,Mongolia,Asia,54310419,56484358,2173939
2008,Malaysia,Asia,26298083987,12432932793,-13865151194
2008,Nepal,Asia,90096095,25976955,-64119140
2008,Oman,Asia,892933731,1475636445,582702714
2008,Pakistan,Asia,3689128807,2069007816,-1620120991
2008,Philippines,Asia,9070650424,6592926318,-2477724106
2008,Palestine,Asia,7685115,34729217,27044102
2008,Qatar,Asia,325847580,3261787090,2935939510
2008,Saudi Arabia,Asia,50803414595,13045827988,-37757586607
2008,Singapore,Asia,16983970036,29916180851,12932210815
2008,Syria,Asia,356036734,451492496,95455762
2008,Thailand,Asia,21948958559,10051471647,-11897486912
2008,Tajikistan,Asia,8007768,28133331,20125563
2008,Turkmenistan,Asia,137280937,58728022,-78552915
2008,Turkey,Asia,4409132611,11209419363,6800286752
2008,Uzbekistan,Asia,291740064,227532092,-64207972
2008,Vietnam,Asia,12456434819,2891390420,-9565044399
2008,Chinese Taipei,Asia,33301996722,25854154916,-7447841806
2008,Yemen,Asia,63250967,837578217,774327250
2008,Albania,Europe,11976239,76444741,64468502
2008,Andorra,Europe,1302599,22724146,21421547
2008,Austria,Europe,7705054746,3451685090,-4253369656
2008,Belgium,Europe,20426268940,28398597549,7972328609
2008,Bulgaria,Europe,406310317,765030506,358720189
2008,Bosnia and Herzegovina,Europe,123574324,336710768,213136444
2008,Belarus,Europe,164578791,308224496,143645705
2008,Switzerland,Europe,18746132148,18045297063,-700835085
2008,Czechia,Europe,2599057723,2002335750,-596721973
2008,Germany,Europe,1.02448E+11,56890549612,-45557258587
2008,Denmark,Europe,6324442927,3020408670,-3304034257
2008,Spain,Europe,11326173539,14198376360,2872202821
2008,Estonia,Europe,811821595,340474007,-471347588
2008,Finland,Europe,6329859926,3329766841,-3000093085
2008,France,Europe,35191993038,32659545604,-2532447434
2008,United Kingdom,Europe,60609150480,52349562506,-8259587974
2008,Gibraltar,Europe,126764,2423073068,2422946304
2008,Greece,Europe,1889937505,2064343750,174406245
2008,Croatia,Europe,363108728,588178674,225069946
2008,Hungary,Europe,2749583908,1667666664,-1081917244
2008,Ireland,Europe,27545119820,8669952038,-18875167782
2008,Iceland,Europe,322421131,471368281,148947150
2008,Italy,Europe,33558123411,15740505767,-17817617644
2008,Lithuania,Europe,768067532,774318587,6251055
2008,Luxembourg,Europe,514262433,1003394217,489131784
2008,Latvia,Europe,256959952,305557873,48597921
2008,Moldova,Europe,22700407,114778120,92077713
2008,North Macedonia,Europe,76331431,100076105,23744674
2008,Malta,Europe,352429567,266512382,-85917185
2008,Montenegro,Europe,1312992,90217949,88904957
2008,Netherlands,Europe,20736876956,40870439873,20133562917
2008,Norway,Europe,7299187826,4095787920,-3203399906
2008,Poland,Europe,2588246694,4453801225,1865554531
2008,Portugal,Europe,2134428951,1959836768,-174592183
2008,Romania,Europe,1057458127,1167443080,109984953
2008,Russia,Europe,15513445352,10278205855,-5235239497
2008,San Marino,Europe,839913,9052656,8212743
2008,Serbia,Europe,71271778,404978603,333706825
2008,Slovakia,Europe,1259555346,753481055,-506074291
2008,Slovenia,Europe,470092442,734331113,264238671
2008,Sweden,Europe,12071598555,5150650027,-6920948528
2008,Ukraine,Europe,2030321243,2216153980,185832737
2008,Aruba,North America,3015850588,644933377,-2370917211
2008,Anguilla,North America,5518359,97830304,92311945
2008,Netherlands Antilles,North America,626225165,2626120127,1999894962
2008,Antigua and Barbuda,North America,1627159,156458758,154831599
2008,Bahamas,North America,494645465,2542847221,2048201756
2008,Belize,North America,139822120,373049550,233227430
2008,Bermuda,North America,4176327,738096935,733920608
2008,Barbados,North America,95410186,580296093,484885907
2008,Canada,North America,3.35364E+11,2.36216E+11,-99147401005
2008,Costa Rica,North America,3954814729,5913640325,1958825596
2008,Cuba,North America,36696,712494656,712457960
2008,Cayman Islands,North America,2965848,562731619,559765771
2008,Dominica,North America,2458970,118621770,116162800
2008,Dominican Republic,North America,4222021963,6564232727,2342210764
2008,Grenada,North America,10610058,109132909,98522851
2008,Greenland,North America,6225537,15752617,9527080
2008,Guatemala,North America,3030971364,5095771279,2064799915
2008,Honduras,North America,4077377364,4395355281,317977917
2008,Haiti,North America,458235321,687800634,229565313
2008,Jamaica,North America,1027050357,2745849472,1718799115
2008,Saint Kitts and Nevis,North America,56964473,160924350,103959877
2008,Saint Lucia,North America,56054016,274423894,218369878
2008,Mexico,North America,2.27976E+11,1.45614E+11,-82362102351
2008,Montserrat,North America,861239,25658419,24797180
2008,Nicaragua,North America,1111008721,945305993,-165702728
2008,Panama,North America,694033095,4779613798,4085580703
2008,El Salvador,North America,2509549805,3106065728,596515923
2008,Saint Pierre and Miquelon,North America,1037152,338981,-698171
2008,Turks and Caicos Islands,North America,6043588,256045841,250002253
2008,Trinidad and Tobago,North America,7683993754,2244838897,-5439154857
2008,Saint Vincent and the Grenadines,North America,2211721,132958124,130746403
2008,British Virgin Islands,North America,7328460,283198729,275870269
2008,Australia,Oceania,10185296202,22723511568,12538215366
2008,Cook Islands,Oceania,1037576,2444139,1406563
2008,Fiji,Oceania,174016961,133542492,-40474469
2008,Micronesia,Oceania,5522277,83983805,78461528
2008,Kiribati,Oceania,1075869,6180940,5105071
2008,Marshall Islands,Oceania,14436118,21922347,7486229
2008,New Caledonia,Oceania,48665519,117442891,68777372
2008,Norfolk Island,Oceania,32584,3586859,3554275
2008,Niue,Oceania,78026,484927,406901
2008,Nauru,Oceania,176646,10612430,10435784
2008,New Zealand,Oceania,3189933570,2628205437,-561728133
2008,Pitcairn Islands,Oceania,445107,3664360,3219253
2008,Palau,Oceania,11287,36654941,36643654
2008,Papua New Guinea,Oceania,105246784,66893324,-38353460
2008,French Polynesia,Oceania,24846600,193454546,168607946
2008,Solomon Islands,Oceania,1479403,1984678,505275
2008,Tokelau,Oceania,5556740,37514786,31958046
2008,Tonga,Oceania,2878476,15752400,12873924
2008,Tuvalu,Oceania,94248,128267,34019
2008,Vanuatu,Oceania,1427181,62528040,61100859
2008,Wallis and Futuna,Oceania,4124,689348,685224
2008,Samoa,Oceania,3657293,31682046,28024753
2008,Argentina,South America,5558443700,7247337348,1688893648
2008,Bolivia,South America,459148889,516427445,57278556
2008,Brazil,South America,27305199061,29077166808,1771967747
2008,Chile,South America,8202478528,11941681129,3739202601
2008,Colombia,South America,14810265958,11575011024,-3235254934
2008,Ecuador,South America,8551049930,3838648833,-4712401097
2008,Falkland Islands,South America,6979409,740862,-6238547
2008,Guyana,South America,132670868,307863050,175192182
2008,Peru,South America,5936948757,5856154310,-80794447
2008,Paraguay,South America,115612895,954119053,838506158
2008,Suriname,South America,131522916,401525577,270002661
2008,Uruguay,South America,232391413,692267548,459876135
2008,Venezuela,South America,36111855790,13028152240,-23083703550
2009,Angola,Africa,8897813678,1620908546,-7276905132
2009,Burundi,Africa,5265933,15188474,9922541
2009,Benin,Africa,462944,394671893,394208949
2009,Burkina Faso,Africa,1321078,77897056,76575978
2009,Botswana,Africa,74820508,136820266,61999758
2009,Central African Republic,Africa,4068420,55624354,51555934
2009,Cote d'Ivoire,Africa,855494866,269713512,-585781354
2009,Cameroon,Africa,201194600,178256614,-22937986
2009,Democratic Republic of the Congo,Africa,296457945,73799781,-222658164
2009,Republic of the Congo,Africa,997686833,288011993,-709674840
2009,Comoros,Africa,1109070,2369753,1260683
2009,Cape Verde,Africa,1243934,13276532,12032598
2009,Djibouti,Africa,2741047,199498154,196757107
2009,Algeria,Africa,10352378365,1275846997,-9076531368
2009,Egypt,Africa,2306497235,5459547303,3153050068
2009,Eritrea,Africa,519740,6300099,5780359
2009,Ethiopia,Africa,89103032,296048297,206945265
2009,Gabon,Africa,3232678208,198607739,-3034070469
2009,Ghana,Africa,146132854,690610167,544477313
2009,Guinea,Africa,80935400,82890375,1954975
2009,Gambia,Africa,1575161,33192759,31617598
2009,Guinea-Bissau,Africa,43820,1528704,1484884
2009,Equatorial Guinea,Africa,2250681346,270233601,-1980447745
2009,Kenya,Africa,248620403,636619941,387999538
2009,Liberia,Africa,78533310,85077132,6543822
2009,Libya,Africa,548146892,842353083,294206191
2009,Lesotho,Africa,248045827,18296578,-229749249
2009,Morocco,Africa,575861152,2119342610,1543481458
2009,Madagascar,Africa,239177653,119655920,-119521733
2009,Mali,Africa,3201254,33921860,30720606
2009,Mozambique,Africa,62565973,214356848,151790875
2009,Mauritania,Africa,32071507,63812702,31741195
2009,Mauritius,Africa,157444684,92965819,-64478865
2009,Malawi,Africa,54440461,61624093,7183632
2009,Mayotte,Africa,52882,6024188,5971306
2009,Namibia,Africa,325807410,137910723,-187896687
2009,Niger,Africa,141500534,108558287,-32942247
2009,Nigeria,Africa,19602591640,3583037211,-16019554429
2009,Rwanda,Africa,21192885,52688966,31496081
2009,Sudan,Africa,10259931,300564644,290304713
2009,Senegal,Africa,6257095,183228043,176970948
2009,Saint Helena,Africa,6001386,2831118,-3170268
2009,Sierra Leone,Africa,25921494,39098596,13177102
2009,Somalia,Africa,192671,3439808,3247137
2009,Sao Tome and Principe,Africa,178513,996788,818275
2009,Eswatini,Africa,174776584,14437445,-160339139
2009,Seychelles,Africa,5209227,6949261,1740034
2009,Chad,Africa,1790348890,59416080,-1730932810
2009,Togo,Africa,6755415,125674565,118919150
2009,Tunisia,Africa,296319657,631389907,335070250
2009,Tanzania,Africa,67946128,178164826,110218698
2009,Uganda,Africa,41764024,91255697,49491673
2009,South Africa,Africa,5181136199,4481295915,-699840284
2009,Zambia,Africa,12073189,64195557,52122368
2009,Zimbabwe,Africa,25852511,240646036,214793525
2009,French South Antarctic Territory,Antarctica,146463,944936,798473
2009,Afghanistan,Asia,22763496,1425684429,1402920933
2009,United Arab Emirates,Asia,1167567141,8773567281,7606000140
2009,Armenia,Asia,67324431,100636243,33311812
2009,Azerbaijan,Asia,1760852668,314627861,-1446224807
2009,Bangladesh,Asia,4074306640,470092674,-3604213966
2009,Bahrain,Asia,393817741,537148204,143330463
2009,Brunei,Asia,54458254,170209867,115751613
2009,Bhutan,Asia,379589,3607693,3228104
2009,Cocos (Keeling) Islands,Asia,811253,1381727,570474
2009,China,Asia,2.48419E+11,67553941940,-1.80865E+11
2009,Christmas Island,Asia,698102,841493,143391
2009,Cyprus,Asia,22942535,133971660,111029125
2009,Georgia,Asia,53462583,294459334,240996751
2009,Hong Kong,Asia,3356480946,19213017081,15856536135
2009,Indonesia,Asia,12870138859,6331713880,-6538424979
2009,India,Asia,20276313747,15695039095,-4581274652
2009,British Indian Ocean Territory,Asia,337971,1730493,1392522
2009,Iran,Asia,67977874,281814642,213836768
2009,Iraq,Asia,8385983490,1643227347,-6742756143
2009,Israel,Asia,18071615205,7613653602,-10457961603
2009,Jordan,Asia,1013370806,1119392338,106021532
2009,Japan,Asia,91269058985,49750254048,-41518804937
2009,Kazakhstan,Asia,891134862,1021115824,129980962
2009,Kyrgyzstan,Asia,4315355,83876842,79561487
2009,Cambodia,Asia,2430979424,138936450,-2292042974
2009,South Korea,Asia,38714671502,27998156280,-10716515222
2009,Kuwait,Asia,3523866952,1806823180,-1717043772
2009,Laos,Asia,44000514,18213276,-25787238
2009,Lebanon,Asia,60936689,2004193189,1943256500
2009,Sri Lanka,Asia,1593452544,308982429,-1284470115
2009,Macau,Asia,191370453,224114462,32744009
2009,Maldives,Asia,2044500,25996628,23952128
2009,Burma,Asia,90593,4359718,4269125
2009,Mongolia,Asia,13551573,36602278,23050705
2009,Malaysia,Asia,20227929721,10131784789,-10096144932
2009,Nepal,Asia,72483303,42499823,-29983480
2009,Oman,Asia,637884598,1183905479,546020881
2009,Pakistan,Asia,3231109114,1765021954,-1466087160
2009,Philippines,Asia,6731499684,5575963644,-1155536040
2009,Palestine,Asia,11048560,36739913,25691353
2009,Qatar,Asia,376747629,1329166808,952419179
2009,Saudi Arabia,Asia,20485743250,10476104546,-10009638704
2009,Singapore,Asia,15001618054,21209857796,6208239742
2009,Syria,Asia,311408880,369995856,58586976
2009,Thailand,Asia,17743716118,6817907450,-10925808668
2009,Tajikistan,Asia,8419384,8285408,-133976
2009,Turkmenistan,Asia,88103314,183390432,95287118
2009,Turkey,Asia,3434678653,7071750601,3637071948
2009,Uzbekistan,Asia,88251220,53424251,-34826969
2009,Vietnam,Asia,12030042197,3226856960,-8803185237
2009,Chinese Taipei,Asia,25504248429,17941937867,-7562310562
2009,Yemen,Asia,29468007,738911402,709443395
2009,Albania,Europe,12197063,74929628,62732565
2009,Andorra,Europe,1797538,14798802,13001264
2009,Austria,Europe,5685875783,2594889588,-3090986195
2009,Belgium,Europe,17819382208,21042137666,3222755458
2009,Bulgaria,Europe,286187680,399609732,113422052
2009,Bosnia and Herzegovina,Europe,29447846,186533286,157085440
2009,Belarus,Europe,52811264,282925064,230113800
2009,Switzerland,Europe,16588891262,12449740302,-4139150960
2009,Czechia,Europe,1869331647,1487731978,-381599669
2009,Germany,Europe,73915947170,41975980939,-31939966231
2009,Denmark,Europe,5794219727,2421065611,-3373154116
2009,Spain,Europe,8216424685,10131044175,1914619490
2009,Estonia,Europe,454285047,237194593,-217090454
2009,Finland,Europe,5098828900,1677986440,-3420842460
2009,France,Europe,27919067437,25715512554,-2203554883
2009,United Kingdom,Europe,49645949075,39913407643,-9732541432
2009,Gibraltar,Europe,907919,1238557548,1237649629
2009,Greece,Europe,1323152645,2165414406,842261761
2009,Croatia,Europe,264206394,480220983,216014589
2009,Hungary,Europe,1974653425,1317191119,-657462306
2009,Ireland,Europe,23326512418,9819096968,-13507415450
2009,Iceland,Europe,165255576,266367655,101112079
2009,Italy,Europe,24001653514,12467549065,-11534104449
2009,Lithuania,Europe,536437089,399150509,-137286580
2009,Luxembourg,Europe,448612761,823995522,375382761
2009,Latvia,Europe,154329595,212196189,57866594
2009,Moldova,Europe,21821975,48489452,26667477
2009,North Macedonia,Europe,13171836,80693970,67522134
2009,Malta,Europe,232120242,205903284,-26216958
2009,Montenegro,Europe,26880710,42367041,15486331
2009,Netherlands,Europe,15216075063,29679286167,14463211104
2009,Norway,Europe,5912750712,3210694260,-2702056452
2009,Poland,Europe,2546175694,2581834658,35658964
2009,Portugal,Europe,1501885784,1175179290,-326706494
2009,Romania,Europe,610772788,640890975,30118187
2009,Russia,Europe,9791131598,5581998813,-4209132785
2009,San Marino,Europe,676388,2212982,1536594
2009,Serbia,Europe,66606236,246870507,180264271
2009,Slovakia,Europe,648788697,322598784,-326189913
2009,Slovenia,Europe,327898392,597567826,269669434
2009,Sweden,Europe,8147059612,4484726239,-3662333373
2009,Ukraine,Europe,330844356,990630477,659786121
2009,Aruba,North America,1192943537,486855157,-706088380
2009,Anguilla,North America,5303564,45159843,39856279
2009,Netherlands Antilles,North America,363137148,1996545004,1633407856
2009,Antigua and Barbuda,North America,10884392,177445760,166561368
2009,Bahamas,North America,770659410,2274909945,1504250535
2009,Belize,North America,124538182,243130431,118592249
2009,Bermuda,North America,4746942,520170108,515423166
2009,Barbados,North America,90180812,474528401,384347589
2009,Canada,North America,2.2281E+11,1.8156E+11,-41249781658
2009,Costa Rica,North America,3088411829,4353745676,1265333847
2009,Cuba,North America,27957,528724430,528696473
2009,Cayman Islands,North America,4178311,477922495,473744184
2009,Dominica,North America,1595739,98211149,96615410
2009,Dominican Republic,North America,3527041758,5247990248,1720948490
2009,Grenada,North America,5348046,77425334,72077288
2009,Greenland,North America,7734499,19424776,11690277
2009,Guatemala,North America,2984701673,4077759946,1093058273
2009,Honduras,North America,3102319597,3177137477,74817880
2009,Haiti,North America,556758046,572838672,16080626
2009,Jamaica,North America,656742579,1580182489,923439910
2009,Saint Kitts and Nevis,North America,52985453,140597515,87612062
2009,Saint Lucia,North America,151333251,196878861,45545610
2009,Mexico,North America,1.80031E+11,1.20294E+11,-59736946151
2009,Montserrat,North America,914980,17079871,16164891
2009,Nicaragua,North America,999382629,721031264,-278351365
2009,Panama,North America,2493146484,3924054737,1430908253
2009,El Salvador,North America,1993912404,2425761757,431849353
2009,Saint Pierre and Miquelon,North America,794538,196493,-598045
2009,Turks and Caicos Islands,North America,6624303,140662600,134038297
2009,Trinidad and Tobago,North America,5312832518,2010205740,-3302626778
2009,Saint Vincent and the Grenadines,North America,3055445,106024447,102969002
2009,British Virgin Islands,North America,2668812,126690236,124021424
2009,Australia,Oceania,7001175551,18407739544,11406563993
2009,Cook Islands,Oceania,864824,2159127,1294303
2009,Fiji,Oceania,124421008,65471809,-58949199
2009,Micronesia,Oceania,5758459,86283141,80524682
2009,Kiribati,Oceania,1423384,4480018,3056634
2009,Marshall Islands,Oceania,13442612,29134270,15691658
2009,New Caledonia,Oceania,98362338,110400535,12038197
2009,Norfolk Island,Oceania,534534,782845,248311
2009,Niue,Oceania,22455,1169055,1146600
2009,Nauru,Oceania,117327,3475490,3358163
2009,New Zealand,Oceania,2531877526,2300450526,-231427000
2009,Pitcairn Islands,Oceania,28748,562003,533255
2009,Palau,Oceania,6067,32981683,32975616
2009,Papua New Guinea,Oceania,100682293,170261787,69579494
2009,French Polynesia,Oceania,19650583,164452281,144801698
2009,Solomon Islands,Oceania,965120,29632180,28667060
2009,Tokelau,Oceania,3802739,11738058,7935319
2009,Tonga,Oceania,1945677,17878655,15932978
2009,Tuvalu,Oceania,87741,143412,55671
2009,Vanuatu,Oceania,3208930,4467522,1258592
2009,Wallis and Futuna,Oceania,33235,510893,477658
2009,Samoa,Oceania,3242418,31877344,28634926
2009,Argentina,South America,3781420705,5759264814,1977844109
2009,Bolivia,South America,497174487,549815452,52640965
2009,Brazil,South America,15909203426,21362839706,5453636280
2009,Chile,South America,6298827282,8093967369,1795140087
2009,Colombia,South America,13389216632,9602565990,-3786650642
2009,Ecuador,South America,4689518002,4096343746,-593174256
2009,Falkland Islands,South America,8038172,2292343,-5745829
2009,Guyana,South America,169674886,279640659,109965773
2009,Peru,South America,4655708973,4483020973,-172688000
2009,Paraguay,South America,69927199,849107609,779180410
2009,Suriname,South America,144060038,457025739,312965701
2009,Uruguay,South America,202588634,672257111,469668477
2009,Venezuela,South America,25349717751,10472424683,-14877293068
2010,Angola,Africa,11385815169,1411668341,-9974146828
2010,Burundi,Africa,3307265,17247692,13940427
2010,Benin,Africa,357891,468898978,468541087
2010,Burkina Faso,Africa,3754887,67524748,63769861
2010,Botswana,Africa,89244753,75566294,-13678459
2010,Central African Republic,Africa,5700926,17018664,11317738
2010,Cote d'Ivoire,Africa,1146244822,227717004,-918527818
2010,Cameroon,Africa,262497887,189557281,-72940606
2010,Democratic Republic of the Congo,Africa,483620692,80914387,-402706305
2010,Republic of the Congo,Africa,839674940,299664474,-540010466
2010,Comoros,Africa,1654964,1256312,-398652
2010,Cape Verde,Africa,1362998,15197642,13834644
2010,Djibouti,Africa,1902417,112605652,110703235
2010,Algeria,Africa,13942448892,1538804742,-12403644150
2010,Egypt,Africa,2415171025,5837262297,3422091272
2010,Eritrea,Africa,101840,2005016,1903176
2010,Ethiopia,Africa,103335514,462787138,359451624
2010,Gabon,Africa,2006096582,237109316,-1768987266
2010,Ghana,Africa,309040721,1056354189,747313468
2010,Guinea,Africa,97880883,75101656,-22779227
2010,Gambia,Africa,6299738,34746625,28446887
2010,Guinea-Bissau,Africa,884844,3323963,2439119
2010,Equatorial Guinea,Africa,2020700928,262646555,-1758054373
2010,Kenya,Africa,304409927,446703863,142293936
2010,Liberia,Africa,147442881,180480405,33037524
2010,Libya,Africa,363394834,1006251862,642857028
2010,Lesotho,Africa,171996437,14594314,-157402123
2010,Morocco,Africa,813645603,2222941407,1409295804
2010,Madagascar,Africa,70673775,138877929,68204154
2010,Mali,Africa,25094818,306353595,281258777
2010,Mozambique,Africa,63839421,234592971,170753550
2010,Mauritania,Africa,48719571,102883563,54163992
2010,Mauritius,Africa,206065534,99498043,-106567491
2010,Malawi,Africa,81276605,58835070,-22441535
2010,Mayotte,Africa,64721,6122756,6058035
2010,Namibia,Africa,246387431,114384418,-132003013
2010,Niger,Africa,104075782,133484023,29408241
2010,Nigeria,Africa,32000870410,4665484912,-27335385498
2010,Rwanda,Africa,23263246,43122591,19859345
2010,Sudan,Africa,7894458,165440279,157545821
2010,Senegal,Africa,7431276,220073738,212642462
2010,Saint Helena,Africa,7152287,674522,-6477765
2010,Sierra Leone,Africa,27627979,56387571,28759592
2010,Somalia,Africa,62333,1235826,1173493
2010,Sao Tome and Principe,Africa,336341,1384117,1047776
2010,Eswatini,Africa,210058868,23028804,-187030064
2010,Seychelles,Africa,7593144,13295465,5702321
2010,Chad,Africa,1861505545,83132546,-1778372999
2010,Togo,Africa,20597387,174966748,154369361
2010,Tunisia,Africa,442112248,721833692,279721444
2010,Tanzania,Africa,57507996,185776040,128268044
2010,Uganda,Africa,43440612,102252876,58812264
2010,South Africa,Africa,7313392984,5794390081,-1519002903
2010,Zambia,Africa,34473570,79453087,44979517
2010,Zimbabwe,Africa,65480500,659437264,593956764
2010,French South Antarctic Territory,Antarctica,16259,571175,554916
2010,Afghanistan,Asia,20917163,1852756573,1831839410
2010,United Arab Emirates,Asia,830409073,10018536446,9188127373
2010,Armenia,Asia,84877109,127849552,42972443
2010,Azerbaijan,Asia,1722645451,220219196,-1502426255
2010,Bangladesh,Asia,4969198168,629546504,-4339651664
2010,Bahrain,Asia,450253479,1124148610,673895131
2010,Brunei,Asia,16616417,175360907,158744490
2010,Bhutan,Asia,527430,4986530,4459100
2010,Cocos (Keeling) Islands,Asia,2204370,681865,-1522505
2010,China,Asia,3.22027E+11,87892558665,-2.34134E+11
2010,Christmas Island,Asia,583751,1487478,903727
2010,Cyprus,Asia,18200561,124504445,106303884
2010,Georgia,Asia,240125175,266619778,26494603
2010,Hong Kong,Asia,3885839671,24636320086,20750480415
2010,Indonesia,Asia,15582683246,8326315358,-7256367888
2010,India,Asia,26060322277,19003295236,-7057027041
2010,British Indian Ocean Territory,Asia,1076469,677422,-399047
2010,Iran,Asia,104353591,242178289,137824698
2010,Iraq,Asia,11141158571,1526183978,-9614974593
2010,Israel,Asia,20180398538,8824681075,-11355717463
2010,Jordan,Asia,1011898550,1126073235,114174685
2010,Japan,Asia,1.15198E+11,60540420334,-54657976229
2010,Kazakhstan,Asia,1191406763,1067658958,-123747805
2010,Kyrgyzstan,Asia,2088377,126309066,124220689
2010,Cambodia,Asia,3096164107,187264113,-2908899994
2010,South Korea,Asia,50021642678,36681562317,-13340080361
2010,Kuwait,Asia,4932994780,2797791793,-2135202987
2010,Laos,Asia,66399526,13517768,-52881758
2010,Lebanon,Asia,71496596,2059237233,1987740637
2010,Sri Lanka,Asia,1793862103,198434803,-1595427300
2010,Macau,Asia,135129873,173194457,38064584
2010,Maldives,Asia,998902,35031717,34032815
2010,Burma,Asia,1692529,28985183,27292654
2010,Mongolia,Asia,10591480,111097468,100505988
2010,Malaysia,Asia,21202133996,13253580831,-7948553165
2010,Nepal,Asia,66999055,57893867,-9105188
2010,Oman,Asia,642750043,1062274072,419524029
2010,Pakistan,Asia,3625378398,1876335096,-1749043302
2010,Philippines,Asia,7665615957,7057899734,-607716223
2010,North Korea,Asia,8763,1762973,1754210
2010,Palestine,Asia,10498219,35145974,24647755
2010,Qatar,Asia,729734504,1811007172,1081272668
2010,Saudi Arabia,Asia,29222231178,11052815241,-18169415937
2010,Singapore,Asia,16751231867,26183042568,9431810701
2010,Syria,Asia,441864490,585871405,144006915
2010,Thailand,Asia,20740549470,9280772971,-11459776499
2010,Tajikistan,Asia,1509081,14419389,12910308
2010,Turkmenistan,Asia,48219131,37343502,-10875629
2010,Turkey,Asia,3942253875,9944385574,6002131699
2010,Uzbekistan,Asia,67176306,68472232,1295926
2010,Vietnam,Asia,14683285148,3851700089,-10831585059
2010,Chinese Taipei,Asia,33385071929,24942650996,-8442420933
2010,Yemen,Asia,206505225,570895049,364389824
2010,Albania,Europe,29697736,76333970,46636234
2010,Andorra,Europe,460993,13030908,12569915
2010,Austria,Europe,6417528349,3059709138,-3357819211
2010,Belgium,Europe,13282987759,20957280995,7674293236
2010,Bulgaria,Europe,321356718,182503501,-138853217
2010,Bosnia and Herzegovina,Europe,26078950,222708631,196629681
2010,Belarus,Europe,101632448,306772192,205139744
2010,Switzerland,Europe,19646885821,12717418886,-6929466935
2010,Czechia,Europe,2390413410,1997037530,-393375880
2010,Germany,Europe,85380110870,48425437304,-36954673566
2010,Denmark,Europe,6169546517,2247362840,-3922183677
2010,Spain,Europe,8709489515,10963081180,2253591665
2010,Estonia,Europe,637961372,244806886,-393154486
2010,Finland,Europe,5156689641,2184894505,-2971795136
2010,France,Europe,29996958275,26343127509,-3653830766
2010,United Kingdom,Europe,54179446596,40262690439,-13916756157
2010,Gibraltar,Europe,663667,996373232,995709565
2010,Greece,Europe,1245717209,1539480927,293763718
2010,Croatia,Europe,348938738,506992441,158053703
2010,Hungary,Europe,2042608796,1387033542,-655575254
2010,Ireland,Europe,29330145656,9594271988,-19735873668
2010,Iceland,Europe,223505891,286914865,63408974
2010,Italy,Europe,27328874624,13757368956,-13571505668
2010,Lithuania,Europe,635561767,628512134,-7049633
2010,Luxembourg,Europe,433134621,928843977,495709356
2010,Latvia,Europe,183142435,207423168,24280733
2010,Moldova,Europe,29465124,63489059,34023935
2010,North Macedonia,Europe,22070235,93088478,71018243
2010,Malta,Europe,267937423,485848419,217910996
2010,Montenegro,Europe,4374869,26252649,21877780
2010,Netherlands,Europe,17804337537,34381314779,16576977242
2010,Norway,Europe,6863291070,3592748547,-3270542523
2010,Poland,Europe,2945378190,3208721696,263343506
2010,Portugal,Europe,1905789103,1142817445,-762971658
2010,Romania,Europe,858703961,813375834,-45328127
2010,Russia,Europe,14130955742,6395807186,-7735148556
2010,San Marino,Europe,4090463,3886895,-203568
2010,Serbia,Europe,121359331,193444400,72085069
2010,Slovakia,Europe,1013280149,394125516,-619154633
2010,Slovenia,Europe,416769249,549254684,132485435
2010,Sweden,Europe,11241083144,4603039950,-6638043194
2010,Ukraine,Europe,892595951,1491715406,599119455
2010,Aruba,North America,15001696,571577168,556575472
2010,Anguilla,North America,2110850,30787765,28676915
2010,Antigua and Barbuda,North America,11130168,156806871,145676703
2010,Bahamas,North America,796763715,2862268712,2065504997
2010,Belize,North America,141824018,304628827,162804809
2010,Bermuda,North America,10688073,580652186,569964113
2010,Barbados,North America,85343344,460467556,375124212
2010,Canada,North America,2.77388E+11,2.21028E+11,-56360131602
2010,Costa Rica,North America,4167874492,5719424996,1551550504
2010,Cuba,North America,347480,359672794,359325314
2010,Cayman Islands,North America,3836522,434434031,430597509
2010,Dominica,North America,1720796,90313727,88592931
2010,Dominican Republic,North America,3766921010,6397777857,2630856847
2010,Grenada,North America,10923329,96177410,85254081
2010,Greenland,North America,8221632,20238120,12016488
2010,Guatemala,North America,3562419767,4870815097,1308395330
2010,Honduras,North America,3256607889,4328369746,1071761857
2010,Haiti,North America,560161698,837093628,276931930
2010,Jamaica,North America,620507630,1706071532,1085563902
2010,Saint Kitts and Nevis,North America,54815333,157990986,103175653
2010,Saint Lucia,North America,125564804,434510773,308945969
2010,Mexico,North America,2.31371E+11,1.50742E+11,-80629135444
2010,Montserrat,North America,572640,3856932,3284292
2010,Nicaragua,North America,1317802690,915073787,-402728903
2010,Panama,North America,2107787181,5324275255,3216488074
2010,El Salvador,North America,2226237304,2595268478,369031174
2010,Saint Pierre and Miquelon,North America,1853785,13729,-1840056
2010,Turks and Caicos Islands,North America,6384274,110938988,104554714
2010,Trinidad and Tobago,North America,5828693730,1957252060,-3871441670
2010,Saint Vincent and the Grenadines,North America,2728559,115868914,113140355
2010,British Virgin Islands,North America,4524997,128081643,123556646
2010,Australia,Oceania,7972660845,20912202086,12939541241
2010,Cook Islands,Oceania,1582368,4098183,2515815
2010,Fiji,Oceania,168912162,69610205,-99301957
2010,Micronesia,Oceania,6225905,63068776,56842871
2010,Kiribati,Oceania,1078785,6364182,5285397
2010,Marshall Islands,Oceania,14245075,81895060,67649985
2010,New Caledonia,Oceania,58354269,111569191,53214922
2010,Norfolk Island,Oceania,10020,536483,526463
2010,Niue,Oceania,19676,1343047,1323371
2010,Nauru,Oceania,217631,2303370,2085739
2010,New Zealand,Oceania,2760985074,2695234950,-65750124
2010,Palau,Oceania,12508,35933178,35920670
2010,Papua New Guinea,Oceania,96398847,157087075,60688228
2010,French Polynesia,Oceania,34162534,162138725,127976191
2010,Solomon Islands,Oceania,1172031,1940521,768490
2010,Tokelau,Oceania,3470289,3376613,-93676
2010,Tonga,Oceania,1867134,21855969,19988835
2010,Tuvalu,Oceania,21891,589631,567740
2010,Vanuatu,Oceania,2998817,8372361,5373544
2010,Wallis and Futuna,Oceania,17414,508742,491328
2010,Samoa,Oceania,4646017,36117165,31471148
2010,Argentina,South America,3763009042,6679319470,2916310428
2010,Bolivia,South America,735835164,662167339,-73667825
2010,Brazil,South America,20086462630,29283749036,9197286406
2010,Chile,South America,7028301443,10079798709,3051497266
2010,Colombia,South America,17178702838,11263132851,-5915569987
2010,Ecuador,South America,6196954308,5703303464,-493650844
2010,Falkland Islands,South America,5233842,2137452,-3096390
2010,Guyana,South America,307208681,330313914,23105233
2010,Peru,South America,6167773000,6150055236,-17717764
2010,Paraguay,South America,91871242,1214464437,1122593195
2010,Suriname,South America,200267006,381544817,181277811
2010,Uruguay,South America,228303392,994181298,765877906
2010,Venezuela,South America,30194545128,10409214626,-19785330502
2011,Angola,Africa,14978306561,1384454567,-13593851994
2011,Burundi,Africa,9507622,45949044,36441422
2011,Benin,Africa,2298089,624033923,621735834
2011,Burkina Faso,Africa,10747063,82294567,71547504
2011,Botswana,Africa,150827524,148891716,-1935808
2011,Central African Republic,Africa,6107704,13231843,7124139
2011,Cote d'Ivoire,Africa,1381654316,157927022,-1223727294
2011,Cameroon,Africa,198889578,231997616,33108038
2011,Democratic Republic of the Congo,Africa,547734124,158237709,-389496415
2011,Republic of the Congo,Africa,2474610251,229602596,-2245007655
2011,Comoros,Africa,682919,1014912,331993
2011,Cape Verde,Africa,1170565,15702730,14532165
2011,Djibouti,Africa,891404,121284484,120393080
2011,Algeria,Africa,14989290872,1509548753,-13479742119
2011,Egypt,Africa,2487856474,6996085395,4508228921
2011,Eritrea,Africa,123993,3917411,3793418
2011,Ethiopia,Africa,117244657,435951893,318707236
2011,Gabon,Africa,4085014509,199437849,-3885576660
2011,Ghana,Africa,891201472,1339747921,448546449
2011,Guinea,Africa,103898388,229973602,126075214
2011,Gambia,Africa,80345,30642752,30562407
2011,Guinea-Bissau,Africa,262984,11238135,10975151
2011,Equatorial Guinea,Africa,1068612366,278444702,-790167664
2011,Kenya,Africa,382987357,356617047,-26370310
2011,Liberia,Africa,151472681,184751679,33278998
2011,Libya,Africa,591874824,301766649,-290108175
2011,Lesotho,Africa,387496295,9759592,-377736703
2011,Morocco,Africa,977159988,3445704514,2468544526
2011,Madagascar,Africa,78543232,72659811,-5883421
2011,Mali,Africa,8293555,87869281,79575726
2011,Mozambique,Africa,47961627,523280160,475318533
2011,Mauritania,Africa,874351,268560508,267686157
2011,Mauritius,Africa,245959913,93479862,-152480051
2011,Malawi,Africa,98671261,112235560,13564299
2011,Mayotte,Africa,3842,4487772,4483930
2011,Namibia,Africa,554317062,129869774,-424447288
2011,Niger,Africa,410323525,90945819,-319377706
2011,Nigeria,Africa,34264660891,4933510257,-29331150634
2011,Rwanda,Africa,19050590,53360185,34309595
2011,Sudan,Africa,8793384,140108625,131315241
2011,Senegal,Africa,7283553,339866822,332583269
2011,Saint Helena,Africa,8123543,1855374,-6268169
2011,Sierra Leone,Africa,25653173,96146760,70493587
2011,Somalia,Africa,89289,5395572,5306283
2011,Sao Tome and Principe,Africa,777396,11440145,10662749
2011,Eswatini,Africa,117969208,30119572,-87849636
2011,Seychelles,Africa,10544893,16884026,6339133
2011,Chad,Africa,2841755015,33860817,-2807894198
2011,Togo,Africa,27773483,222860225,195086742
2011,Tunisia,Africa,391575549,738601538,347025989
2011,Tanzania,Africa,71194523,299300022,228105499
2011,Uganda,Africa,49394032,134588044,85194012
2011,South Africa,Africa,8643821791,8074107106,-569714685
2011,Zambia,Africa,48345349,133147135,84801786
2011,Zimbabwe,Africa,29352241,448377443,419025202
2011,French South Antarctic Territory,Antarctica,17103,782755,765652
2011,Afghanistan,Asia,7165842,2589145226,2581979384
2011,United Arab Emirates,Asia,1747280495,12102392381,10355111886
2011,Armenia,Asia,103406816,130196488,26789672
2011,Azerbaijan,Asia,2288157237,627356349,-1660800888
2011,Bangladesh,Asia,5422678805,1270914368,-4151764437
2011,Bahrain,Asia,618943619,857508503,238564884
2011,Brunei,Asia,25379990,242554990,217175000
2011,Bhutan,Asia,604226,4102358,3498132
2011,Cocos (Keeling) Islands,Asia,1586433,897989,-688444
2011,China,Asia,3.48512E+11,1.00487E+11,-2.48025E+11
2011,Christmas Island,Asia,1253801,1281723,27922
2011,Cyprus,Asia,28227029,223288951,195061922
2011,Georgia,Asia,161761355,432768980,271007625
2011,Hong Kong,Asia,3796356767,33710291353,29913934586
2011,Indonesia,Asia,18230428131,9114595540,-9115832591
2011,India,Asia,34133882974,21381124639,-12752758335
2011,British Indian Ocean Territory,Asia,5595022,1657392,-3937630
2011,Iran,Asia,1382591,253038478,251655887
2011,Iraq,Asia,15238265455,2259897452,-12978368003
2011,Israel,Asia,21902330840,10899170959,-11003159881
2011,Jordan,Asia,1121361823,1527096643,405734820
2011,Japan,Asia,1.23291E+11,65800487819,-57490646843
2011,Kazakhstan,Asia,1265225513,1376702552,111477039
2011,Kyrgyzstan,Asia,2877689,157379361,154501672
2011,Cambodia,Asia,3559293955,231825068,-3327468887
2011,South Korea,Asia,56950783782,41799649073,-15151134709
2011,Kuwait,Asia,7030660700,2783236391,-4247424309
2011,Laos,Asia,64611135,32560881,-32050254
2011,Lebanon,Asia,69906925,1972475633,1902568708
2011,Sri Lanka,Asia,2154938378,297325409,-1857612969
2011,Macau,Asia,98338494,251289664,152951170
2011,Maldives,Asia,2375755,40249114,37873359
2011,Burma,Asia,8105793,186216889,178111096
2011,Mongolia,Asia,8991181,309407687,300416506
2011,Malaysia,Asia,22402397247,12220438022,-10181959225
2011,Nepal,Asia,84272140,60876705,-23395435
2011,Oman,Asia,2067639788,1401366839,-666272949
2011,Pakistan,Asia,3925534262,1994563098,-1930971164
2011,Philippines,Asia,9256576464,7151600637,-2104975827
2011,Palestine,Asia,12816058,40071595,27255537
2011,Qatar,Asia,1155755548,1858485603,702730055
2011,Saudi Arabia,Asia,43299268514,13445946311,-29853322203
2011,Singapore,Asia,18432822521,29416758053,10983935532
2011,Syria,Asia,367743005,228561100,-139181905
2011,Thailand,Asia,22932441518,11443929313,-11488512205
2011,Tajikistan,Asia,11790529,12595694,805165
2011,Turkmenistan,Asia,42609734,59749382,17139648
2011,Turkey,Asia,4745761422,14719028865,9973267443
2011,Uzbekistan,Asia,50543320,66218299,15674979
2011,Vietnam,Asia,17941543997,4605039861,-13336504136
2011,Chinese Taipei,Asia,38213312821,24991689625,-13221623196
2011,Yemen,Asia,547327099,808854851,261527752
2011,Albania,Europe,25745954,81404655,55658701
2011,Andorra,Europe,601203,14095551,13494348
2011,Austria,Europe,8872812515,3732389225,-5140423290
2011,Belgium,Europe,14728695039,24197504463,9468809424
2011,Bulgaria,Europe,424808288,290556344,-134251944
2011,Bosnia and Herzegovina,Europe,48000427,300580837,252580410
2011,Belarus,Europe,115805894,370640877,254834983
2011,Switzerland,Europe,24150362991,21209259936,-2941103055
2011,Czechia,Europe,3188896706,2115012862,-1073883844
2011,Germany,Europe,1.00611E+11,51300072150,-49311327781
2011,Denmark,Europe,6856911724,2249620396,-4607291328
2011,Spain,Europe,11207901658,12860416355,1652514697
2011,Estonia,Europe,1567266429,352949547,-1214316882
2011,Finland,Europe,4213294934,2614466220,-1598828714
2011,France,Europe,32842342346,30333310198,-2509032148
2011,United Kingdom,Europe,54070274553,44593843521,-9476431032
2011,Gibraltar,Europe,207186,2279401619,2279194433
2011,Greece,Europe,1907828422,1213519323,-694309099
2011,Croatia,Europe,413288654,523900384,110611730
2011,Hungary,Europe,2432737195,1748424034,-684313161
2011,Ireland,Europe,32037485623,11511623335,-20525862288
2011,Iceland,Europe,220164311,547103080,326938769
2011,Italy,Europe,32414673907,16496445586,-15918228321
2011,Lithuania,Europe,864286413,969199069,104912656
2011,Luxembourg,Europe,613288008,1389704102,776416094
2011,Latvia,Europe,235602713,324601536,88998823
2011,Moldova,Europe,34152530,79139094,44986564
2011,North Macedonia,Europe,45466282,71555754,26089472
2011,Malta,Europe,255489149,547147921,291658772
2011,Montenegro,Europe,5015715,25056461,20040746
2011,Netherlands,Europe,22104747023,40839852857,18735105834
2011,Norway,Europe,8883925267,4209607147,-4674318120
2011,Poland,Europe,3901242807,3348734822,-552507985
2011,Portugal,Europe,2273008178,1481948287,-791059891
2011,Romania,Europe,1223623320,1025985888,-197637432
2011,Russia,Europe,18676727288,8803021042,-9873706246
2011,San Marino,Europe,5059143,1881566,-3177577
2011,Serbia,Europe,104386562,224043816,119657254
2011,Slovakia,Europe,1245918632,463519660,-782398972
2011,Slovenia,Europe,495383784,838617533,343233749
2011,Sweden,Europe,11503259393,5186115173,-6317144220
2011,Ukraine,Europe,1226602973,2234745844,1008142871
2011,Aruba,North America,3060960941,749901781,-2311059160
2011,Anguilla,North America,4182054,26505363,22323309
2011,Antigua and Barbuda,North America,12315336,158640035,146324699
2011,Bahamas,North America,740816445,3260595210,2519778765
2011,Belize,North America,228809025,359353881,130544856
2011,Bermuda,North America,8386365,571053647,562667282
2011,Barbados,North America,80310679,513243050,432932371
2011,Canada,North America,3.16675E+11,2.49272E+11,-67402184840
2011,Costa Rica,North America,4830426277,6987278669,2156852392
2011,Cuba,North America,5700,359756496,359750796
2011,Curaçao,North America,546592031,456153555,-90438476
2011,Cayman Islands,North America,5669444,455689027,450019583
2011,Dominica,North America,1090836,62585661,61494825
2011,Dominican Republic,North America,4615032849,7273022970,2657990121
2011,Grenada,North America,10647606,99734967,89087361
2011,Greenland,North America,7311442,17295665,9984223
2011,Guatemala,North America,4947353391,6264891641,1317538250
2011,Honduras,North America,3706266330,5815756660,2109490330
2011,Haiti,North America,754593966,754278615,-315351
2011,Jamaica,North America,961718704,2016360171,1054641467
2011,Saint Kitts and Nevis,North America,57332051,140660746,83328695
2011,Saint Lucia,North America,47310063,302217818,254907755
2011,Saint Martin,North America,4311557,376874392,372562835
2011,Mexico,North America,2.68785E+11,1.8688E+11,-81905145930
2011,Montserrat,North America,356627,18855006,18498379
2011,Nicaragua,North America,945907665,1036356423,90448758
2011,Panama,North America,3674146206,7607702611,3933556405
2011,El Salvador,North America,2600932224,3235814004,634881780
2011,Saint Pierre and Miquelon,North America,208970,109213,-99757
2011,Turks and Caicos Islands,North America,11590952,156173666,144582714
2011,Trinidad and Tobago,North America,7284481094,2629734030,-4654747064
2011,Saint Vincent and the Grenadines,North America,2958889,118719016,115760127
2011,British Virgin Islands,North America,5832436,131757507,125925071
2011,Australia,Oceania,9422004989,25765555619,16343550630
2011,Cook Islands,Oceania,764129,4190499,3426370
2011,Fiji,Oceania,153609852,97151842,-56458010
2011,Micronesia,Oceania,2473787,70484308,68010521
2011,Kiribati,Oceania,647590,16693606,16046016
2011,Marshall Islands,Oceania,15186901,130130475,114943574
2011,New Caledonia,Oceania,77243366,140444970,63201604
2011,Norfolk Island,Oceania,218994,951633,732639
2011,Niue,Oceania,30003,674542,644539
2011,Nauru,Oceania,308641,467747,159106
2011,New Zealand,Oceania,3841624423,3945487371,103862948
2011,Palau,Oceania,25063,35859772,35834709
2011,Papua New Guinea,Oceania,149222550,335025723,185803173
2011,French Polynesia,Oceania,38952928,162697655,123744727
2011,Solomon Islands,Oceania,1412943,5626454,4213511
2011,Tokelau,Oceania,6357990,4545951,-1812039
2011,Tonga,Oceania,1993691,22750567,20756876
2011,Tuvalu,Oceania,651,685884,685233
2011,Vanuatu,Oceania,2987699,5702444,2714745
2011,Wallis and Futuna,Oceania,5616,323512,317896
2011,Samoa,Oceania,3984520,36581607,32597087
2011,Argentina,South America,4425611100,8516324810,4090713710
2011,Bolivia,South America,926748487,739273987,-187474500
2011,Brazil,South America,26747488326,36339523685,9592035359
2011,Chile,South America,9137104468,15134381202,5997276734
2011,Colombia,South America,22034947260,14204148533,-7830798727
2011,Ecuador,South America,9709738643,6234734894,-3475003749
2011,Falkland Islands,South America,6566486,3354388,-3212098
2011,Guyana,South America,238470962,406536553,168065591
2011,Peru,South America,6429976779,7698175537,1268198758
2011,Paraguay,South America,167827010,1417331543,1249504533
2011,Suriname,South America,334542563,526803157,192260594
2011,Uruguay,South America,296064890,1174287931,878223041
2011,Venezuela,South America,38849738091,12307016660,-26542721431
2012,Angola,Africa,8603142221,1789784075,-6813358146
2012,Burundi,Africa,4807632,42108369,37300737
2012,Benin,Africa,4443948,567191211,562747263
2012,Burkina Faso,Africa,58185618,168995464,110809846
2012,Botswana,Africa,136749702,161533455,24783753
2012,Central African Republic,Africa,4165935,11031926,6865991
2012,Cote d'Ivoire,Africa,1007401314,249795271,-757606043
2012,Cameroon,Africa,245409898,271157603,25747705
2012,Democratic Republic of the Congo,Africa,40143239,188437527,148294288
2012,Republic of the Congo,Africa,604992531,238227432,-366765099
2012,Comoros,Africa,630174,931438,301264
2012,Cape Verde,Africa,4096050,70520511,66424461
2012,Djibouti,Africa,1606966,110950026,109343060
2012,Algeria,Africa,10645296218,1543837475,-9101458743
2012,Egypt,Africa,3114408283,5421424682,2307016399
2012,Eritrea,Africa,212261,5420454,5208193
2012,Ethiopia,Africa,129079788,358405212,229325424
2012,Gabon,Africa,1676820098,257345706,-1419474392
2012,Ghana,Africa,396240579,1398593537,1002352958
2012,Guinea,Africa,121413467,134520010,13106543
2012,Gambia,Africa,395676,29542161,29146485
2012,Guinea-Bissau,Africa,67826,20533803,20465977
2012,Equatorial Guinea,Africa,1507752639,225334869,-1282417770
2012,Kenya,Africa,385165308,404043475,18878167
2012,Liberia,Africa,135355353,229261271,93905918
2012,Libya,Africa,2226542120,539971980,-1686570140
2012,Lesotho,Africa,324140140,11298314,-312841826
2012,Morocco,Africa,1052848132,2719995394,1667147262
2012,Madagascar,Africa,83605291,88664427,5059136
2012,Mali,Africa,10503956,109847625,99343669
2012,Mozambique,Africa,54620113,383971629,329351516
2012,Mauritania,Africa,697022,325049525,324352503
2012,Mauritius,Africa,239106151,111828299,-127277852
2012,Malawi,Africa,65317532,87864122,22546590
2012,Mayotte,Africa,10632,11413503,11402871
2012,Namibia,Africa,218451866,134143458,-84308408
2012,Niger,Africa,96158750,112336269,16177519
2012,Nigeria,Africa,23194678251,5066276984,-18128401267
2012,Rwanda,Africa,38945715,46886209,7940494
2012,Sudan,Africa,7356033,102817269,95461236
2012,Senegal,Africa,17487558,198829174,181341616
2012,Saint Helena,Africa,6399793,994565,-5405228
2012,Sierra Leone,Africa,17098362,90671556,73573194
2012,Somalia,Africa,211049,16337174,16126125
2012,South Sudan,Africa,342,27039106,27038764
2012,Sao Tome and Principe,Africa,575436,3025171,2449735
2012,Eswatini,Africa,87291400,33283364,-54008036
2012,Seychelles,Africa,9524370,14317722,4793352
2012,Chad,Africa,2354475247,33895104,-2320580143
2012,Togo,Africa,47981425,472569947,424588522
2012,Tunisia,Africa,713297205,691812345,-21484860
2012,Tanzania,Africa,126764213,247359827,120595614
2012,Uganda,Africa,32572173,84547047,51974874
2012,South Africa,Africa,8119007337,7502624909,-616382428
2012,Zambia,Africa,65231258,234712496,169481238
2012,Zimbabwe,Africa,32583755,397890271,365306516
2012,French South Antarctic Territory,Antarctica,27798,1175310,1147512
2012,Afghanistan,Asia,10871614,1214020031,1203148417
2012,United Arab Emirates,Asia,2000657837,17667347088,15666689251
2012,Armenia,Asia,91889556,104990534,13100978
2012,Azerbaijan,Asia,1580713424,761981188,-818732236
2012,Bangladesh,Asia,5200516646,606930312,-4593586334
2012,Bahrain,Asia,677483195,958022918,280539723
2012,Brunei,Asia,90683684,197930875,107247191
2012,Bhutan,Asia,637132,4745702,4108570
2012,Cocos (Keeling) Islands,Asia,1001672,863089,-138583
2012,China,Asia,3.80391E+11,1.08875E+11,-2.71516E+11
2012,Christmas Island,Asia,485125,3800170,3315045
2012,Cyprus,Asia,68646953,143197044,74550091
2012,Georgia,Asia,238673717,358617108,119943391
2012,Hong Kong,Asia,3798389853,34426631660,30628241807
2012,Indonesia,Asia,17043774587,9968345214,-7075429373
2012,India,Asia,37517153151,21303541246,-16213611905
2012,British Indian Ocean Territory,Asia,19798465,2650992,-17147473
2012,Iran,Asia,2117827,251109286,248991459
2012,Iraq,Asia,17016486247,1845749350,-15170736897
2012,Israel,Asia,20727184248,11226364634,-9500819614
2012,Jordan,Asia,1221415374,1782862103,561446729
2012,Japan,Asia,1.38524E+11,65293238452,-73230391395
2012,Kazakhstan,Asia,601521163,1305004983,703483820
2012,Kyrgyzstan,Asia,5542463,195044406,189501943
2012,Cambodia,Asia,3404552089,250332991,-3154219098
2012,South Korea,Asia,60321466864,40111466762,-20210000102
2012,Kuwait,Asia,11493640945,2557145867,-8936495078
2012,Laos,Asia,25231739,35612177,10380438
2012,Lebanon,Asia,70561413,1779542906,1708981493
2012,Sri Lanka,Asia,2149956188,242644286,-1907311902
2012,Macau,Asia,86407987,268068868,181660881
2012,Maldives,Asia,5209916,42994895,37784979
2012,Burma,Asia,11895715,75176456,63280741
2012,Mongolia,Asia,8689701,601313097,592623396
2012,Malaysia,Asia,24361096631,12036682266,-12324414365
2012,Nepal,Asia,80461580,40372871,-40088709
2012,Oman,Asia,1220998198,1898891136,677892938
2012,Pakistan,Asia,3774721260,1519658339,-2255062921
2012,Philippines,Asia,9882651503,7642968319,-2239683184
2012,Palestine,Asia,13947099,36024963,22077864
2012,Qatar,Asia,790254448,2277177237,1486922789
2012,Saudi Arabia,Asia,50511149088,16654439570,-33856709518
2012,Singapore,Asia,16619597755,29538972088,12919374333
2012,Syria,Asia,19439474,19412945,-26529
2012,Thailand,Asia,24246482371,11002426942,-13244055429
2012,Tajikistan,Asia,25681952,14100775,-11581177
2012,Turkmenistan,Asia,85602863,82042175,-3560688
2012,Timor-Leste,Asia,3862,1122444,1118582
2012,Turkey,Asia,6052509420,12447613572,6395104152
2012,Uzbekistan,Asia,25723553,70531252,44807699
2012,Vietnam,Asia,19087074268,4790737932,-14296336336
2012,Chinese Taipei,Asia,36226390328,23326075616,-12900314712
2012,Yemen,Asia,138506063,610675058,472168995
2012,Albania,Europe,15719577,105076653,89357076
2012,Andorra,Europe,643741,10056565,9412824
2012,Austria,Europe,8811916706,4160960613,-4650956093
2012,Belgium,Europe,14886996062,23561912139,8674916077
2012,Bulgaria,Europe,538199328,249725393,-288473935
2012,Bosnia and Herzegovina,Europe,52424150,216870372,164446222
2012,Belarus,Europe,111953449,335337735,223384286
2012,Switzerland,Europe,24706182780,25150661138,444478358
2012,Czechia,Europe,3571423700,2292993617,-1278430083
2012,Germany,Europe,1.0992E+11,50253811786,-59666448102
2012,Denmark,Europe,7050040021,2185697696,-4864342325
2012,Spain,Europe,11681113366,10515207313,-1165906053
2012,Estonia,Europe,1329133934,278047407,-1051086527
2012,Finland,Europe,5130288334,2480560584,-2649727750
2012,France,Europe,34213138042,31038057890,-3175080152
2012,United Kingdom,Europe,56061737727,45775256123,-10286481604
2012,Gibraltar,Europe,436075,3676398806,3675962731
2012,Greece,Europe,1411448693,825895722,-585552971
2012,Croatia,Europe,405950130,399950236,-5999894
2012,Hungary,Europe,2591914183,1664981108,-926933075
2012,Ireland,Europe,28167813489,12074590035,-16093223454
2012,Iceland,Europe,258935025,415935637,157000612
2012,Italy,Europe,34312566450,15554966619,-18757599831
2012,Lithuania,Europe,480719970,671073824,190353854
2012,Luxembourg,Europe,472122037,1967568849,1495446812
2012,Latvia,Europe,175549445,290072200,114522755
2012,Moldova,Europe,42360634,80772595,38411961
2012,North Macedonia,Europe,72603495,67066818,-5536677
2012,Malta,Europe,284339821,290444742,6104921
2012,Montenegro,Europe,3741604,20622129,16880525
2012,Netherlands,Europe,22822006652,39229727341,16407720689
2012,Norway,Europe,6447792232,3663387805,-2784404427
2012,Poland,Europe,3956440735,3662469518,-293971217
2012,Portugal,Europe,2488578509,1184057522,-1304520987
2012,Romania,Europe,1292557647,1031571161,-260986486
2012,Russia,Europe,13742336977,10866108840,-2876228137
2012,San Marino,Europe,4844295,1313257,-3531038
2012,Serbia,Europe,139587036,222195540,82608504
2012,Slovakia,Europe,1599076840,461061483,-1138015357
2012,Slovenia,Europe,485938937,495162506,9223569
2012,Sweden,Europe,10485754416,5304853986,-5180900430
2012,Ukraine,Europe,1161117633,2170885796,1009768163
2012,Aruba,North America,750759526,742194578,-8564948
2012,Anguilla,North America,3291765,23673603,20381838
2012,Antigua and Barbuda,North America,9227259,197845229,188617970
2012,Bahamas,North America,446519348,3282809853,2836290505
2012,Belize,North America,184512616,280317401,95804785
2012,Bermuda,North America,13904478,503290703,489386225
2012,Barbados,North America,151687821,491666540,339978719
2012,Canada,North America,3.23418E+11,2.56821E+11,-66596982650
2012,Costa Rica,North America,5426099547,8011974948,2585875401
2012,Cuba,North America,95955,457338144,457242189
2012,Curaçao,North America,840404174,644853316,-195550858
2012,Cayman Islands,North America,6353816,492466465,486112649
2012,Dominica,North America,2473614,85035220,82561606
2012,Dominican Republic,North America,4468883687,6913980864,2445097177
2012,Grenada,North America,11109762,92262284,81152522
2012,Greenland,North America,6387538,18054711,11667173
2012,Guatemala,North America,4622845278,6088391054,1465545776
2012,Honduras,North America,4340610982,5280731710,940120728
2012,Haiti,North America,788460071,703651961,-84808110
2012,Jamaica,North America,839599823,2091611275,1252011452
2012,Saint Kitts and Nevis,North America,61598158,121863724,60265566
2012,Saint Lucia,North America,31768533,310185751,278417218
2012,Saint Martin,North America,5810940,665923959,660113019
2012,Mexico,North America,2.82165E+11,1.9858E+11,-83584836513
2012,Montserrat,North America,1847327,21915594,20068267
2012,Nicaragua,North America,3448556183,1118900579,-2329655604
2012,Panama,North America,3895785726,8861401899,4965616173
2012,El Salvador,North America,2603041344,3032920997,429879653
2012,Saint Pierre and Miquelon,North America,554,164411,163857
2012,Turks and Caicos Islands,North America,14314579,155172784,140858205
2012,Trinidad and Tobago,North America,6241907332,2922857203,-3319050129
2012,Saint Vincent and the Grenadines,North America,2660573,133670127,131009554
2012,British Virgin Islands,North America,6449489,150763919,144314430
2012,Australia,Oceania,9011612967,28033669443,19022056476
2012,Cook Islands,Oceania,1384038,4735893,3351855
2012,Fiji,Oceania,216788058,68480644,-148307414
2012,Micronesia,Oceania,1471577,70063582,68592005
2012,Kiribati,Oceania,588713,5913136,5324423
2012,Marshall Islands,Oceania,19700064,126583523,106883459
2012,New Caledonia,Oceania,65928986,110347074,44418088
2012,Norfolk Island,Oceania,52518,1119803,1067285
2012,Niue,Oceania,118258,720725,602467
2012,Nauru,Oceania,473409,2108621,1635212
2012,New Zealand,Oceania,3473158943,3014373396,-458785547
2012,Palau,Oceania,692463,43796608,43104145
2012,Papua New Guinea,Oceania,124090441,471258099,347167658
2012,French Polynesia,Oceania,36144576,153118435,116973859
2012,Solomon Islands,Oceania,1551600,5815693,4264093
2012,Tokelau,Oceania,4723157,12748673,8025516
2012,Tonga,Oceania,2537149,32824997,30287848
2012,Tuvalu,Oceania,38212,581326,543114
2012,Vanuatu,Oceania,2724324,57713075,54988751
2012,Samoa,Oceania,3137659,42557773,39420114
2012,Argentina,South America,4150827121,8922932670,4772105549
2012,Bolivia,South America,1281959457,862702499,-419256958
2012,Brazil,South America,27329429443,34475595579,7146166136
2012,Chile,South America,9721910293,18636361953,8914451660
2012,Colombia,South America,22419435615,14855136213,-7564299402
2012,Ecuador,South America,10558611702,6600555864,-3958055838
2012,Falkland Islands,South America,11467782,3928894,-7538888
2012,Guyana,South America,397003188,411734344,14731156
2012,Peru,South America,6584692344,8228634696,1643942352
2012,Paraguay,South America,292566654,1347771103,1055204449
2012,Suriname,South America,304736441,570789494,266053053
2012,Uruguay,South America,364223839,1113662884,749439045
2012,Venezuela,South America,34551114227,16388966679,-18162147548
2013,Angola,Africa,7362281192,1524388507,-5837892685
2013,Burundi,Africa,4734199,28996449,24262250
2013,Benin,Africa,6409916,667509951,661100035
2013,Burkina Faso,Africa,6709897,183472669,176762772
2013,Botswana,Africa,146480244,95119134,-51361110
2013,Central African Republic,Africa,2804613,11191350,8386737
2013,Cote d'Ivoire,Africa,1043073845,273732552,-769341293
2013,Cameroon,Africa,401146428,336828746,-64317682
2013,Democratic Republic of the Congo,Africa,76248470,155154211,78905741
2013,Republic of the Congo,Africa,1164475272,225723833,-938751439
2013,Comoros,Africa,1731196,1217016,-514180
2013,Cape Verde,Africa,2391702,13070183,10678481
2013,Djibouti,Africa,477374,153783177,153305803
2013,Algeria,Africa,5388953794,2020188813,-3368764981
2013,Egypt,Africa,1935523805,5439576613,3504052808
2013,Eritrea,Africa,153375,6170389,6017014
2013,Ethiopia,Africa,150292853,379006747,228713894
2013,Gabon,Africa,1009979017,303243006,-706736011
2013,Ghana,Africa,394098027,1084757002,690658975
2013,Guinea,Africa,136692597,88337271,-48355326
2013,Gambia,Africa,1729804,35790508,34060704
2013,Guinea-Bissau,Africa,3210285,6528413,3318128
2013,Equatorial Guinea,Africa,813999894,735478129,-78521765
2013,Kenya,Africa,386851552,535890863,149039311
2013,Liberia,Africa,92688735,163478869,70790134
2013,Libya,Africa,2349105091,849507272,-1499597819
2013,Lesotho,Africa,214412382,2750464,-211661918
2013,Morocco,Africa,1122482744,3046124509,1923641765
2013,Madagascar,Africa,155944498,87737528,-68206970
2013,Mali,Africa,3573083,47367892,43794809
2013,Mozambique,Africa,184883893,322015064,137131171
2013,Mauritania,Africa,145771289,321949726,176178437
2013,Mauritius,Africa,260824524,73515820,-187308704
2013,Malawi,Africa,89432014,75533087,-13898927
2013,Mayotte,Africa,9517,8190265,8180748
2013,Namibia,Africa,243435227,163784687,-79650540
2013,Niger,Africa,122563138,98350928,-24212210
2013,Nigeria,Africa,12131759506,6384688611,-5747070895
2013,Rwanda,Africa,20599983,38641115,18041132
2013,Sudan,Africa,8491983,109687132,101195149
2013,Senegal,Africa,30810692,260980988,230170296
2013,Saint Helena,Africa,7656394,297584,-7358810
2013,Sierra Leone,Africa,39186024,78481841,39295817
2013,Somalia,Africa,350961,15135225,14784264
2013,South Sudan,Africa,163321,12556706,12393385
2013,Sao Tome and Principe,Africa,312209,4848736,4536527
2013,Eswatini,Africa,80471521,22871491,-57600030
2013,Seychelles,Africa,5781744,14983343,9201599
2013,Chad,Africa,2212783441,39152657,-2173630784
2013,Togo,Africa,8643911,1026998434,1018354523
2013,Tunisia,Africa,747230084,975029847,227799763
2013,Tanzania,Africa,82431746,310316764,227885018
2013,Uganda,Africa,48829158,132720053,83890895
2013,South Africa,Africa,7214596373,6589905488,-624690885
2013,Zambia,Africa,43000888,198220988,155220100
2013,Zimbabwe,Africa,14727321,148610161,133882840
2013,French South Antarctic Territory,Antarctica,183356,1609267,1425911
2013,Afghanistan,Asia,17690062,1104961758,1087271696
2013,United Arab Emirates,Asia,2483157302,19251423650,16768266348
2013,Armenia,Asia,94644207,104875134,10230927
2013,Azerbaijan,Asia,1000928668,387340414,-613588254
2013,Bangladesh,Asia,5768253332,790401042,-4977852290
2013,Bahrain,Asia,504694781,844653700,339958919
2013,Brunei,Asia,17198517,383899642,366701125
2013,Bhutan,Asia,434442,2293248,1858806
2013,Cocos (Keeling) Islands,Asia,1042455,20955484,19913029
2013,China,Asia,3.97212E+11,1.22557E+11,-2.74655E+11
2013,Christmas Island,Asia,1044612,431397,-613215
2013,Cyprus,Asia,96760678,116855116,20094438
2013,Georgia,Asia,153272857,386058991,232786134
2013,Hong Kong,Asia,3518725856,39184947148,35666221292
2013,Indonesia,Asia,17805217551,7624917106,-10180300445
2013,India,Asia,41475977631,20598533165,-20877444466
2013,British Indian Ocean Territory,Asia,18057195,645889,-17411306
2013,Iran,Asia,2120708,315986135,313865427
2013,Iraq,Asia,11992435815,1873190215,-10119245600
2013,Israel,Asia,21260725388,10524610212,-10736115176
2013,Jordan,Asia,1339084610,1940048617,600964007
2013,Japan,Asia,1.30537E+11,63706645299,-66829977041
2013,Kazakhstan,Asia,534133919,1492696508,958562589
2013,Kyrgyzstan,Asia,5322784,189388336,184065552
2013,Cambodia,Asia,3719215909,264003820,-3455212089
2013,South Korea,Asia,63719639388,38927980220,-24791659168
2013,Kuwait,Asia,11442463149,2692634707,-8749828442
2013,Laos,Asia,43194120,38177336,-5016784
2013,Lebanon,Asia,80546977,1330748728,1250201751
2013,Sri Lanka,Asia,2468924868,372679111,-2096245757
2013,Macau,Asia,69784008,135382469,65598461
2013,Maldives,Asia,7463985,30148529,22684544
2013,Burma,Asia,36960701,195401010,158440309
2013,Mongolia,Asia,20582567,417746127,397163560
2013,Malaysia,Asia,21156799620,12792919166,-8363880454
2013,Nepal,Asia,82855982,43314952,-39541030
2013,Oman,Asia,908136939,1562596702,654459763
2013,Pakistan,Asia,3755054015,1630544359,-2124509656
2013,Philippines,Asia,10361146571,7857786484,-2503360087
2013,Palestine,Asia,10671929,33827146,23155217
2013,Qatar,Asia,929185279,2318157308,1388972029
2013,Saudi Arabia,Asia,47668785926,17425437270,-30243348656
2013,Singapore,Asia,16803873269,28897680097,12093806828
2013,Syria,Asia,19369202,21642124,2272922
2013,Thailand,Asia,24221892650,12712202071,-11509690579
2013,Tajikistan,Asia,159360,19430909,19271549
2013,Turkmenistan,Asia,31048193,95946083,64897890
2013,Timor-Leste,Asia,7462111,3100369,-4361742
2013,Turkey,Asia,6860967933,11885878037,5024910104
2013,Uzbekistan,Asia,24519048,116671881,92152833
2013,Vietnam,Asia,24109145366,5241554432,-18867590934
2013,Chinese Taipei,Asia,34576235027,23183508697,-11392726330
2013,Yemen,Asia,73972689,728423613,654450924
2013,Albania,Europe,20494450,114474877,93980427
2013,Andorra,Europe,1785323,10986191,9200868
2013,Austria,Europe,9167374023,4464610831,-4702763192
2013,Belgium,Europe,14707543346,25440188139,10732644793
2013,Bulgaria,Europe,489236832,289240009,-199996823
2013,Bosnia and Herzegovina,Europe,58834589,192068070,133233481
2013,Belarus,Europe,126932418,370283131,243350713
2013,Switzerland,Europe,25911739888,24720845734,-1190894154
2013,Czechia,Europe,3605090148,2322654452,-1282435696
2013,Germany,Europe,1.16537E+11,49850071526,-66686935609
2013,Denmark,Europe,6786422403,2036561294,-4749861109
2013,Spain,Europe,11691742728,11636600667,-55142061
2013,Estonia,Europe,688848868,327275373,-361573495
2013,Finland,Europe,5054396583,2374099118,-2680297465
2013,France,Europe,36373337200,33667426271,-2705910929
2013,United Kingdom,Europe,54388826084,38163980833,-16224845251
2013,Gibraltar,Europe,74764,2532667424,2532592660
2013,Greece,Europe,1369128409,692009743,-677118666
2013,Croatia,Europe,364949536,256881950,-108067586
2013,Hungary,Europe,3304714981,1712629087,-1592085894
2013,Ireland,Europe,26868125009,11088224043,-15779900966
2013,Iceland,Europe,257428939,392384928,134955989
2013,Italy,Europe,36107532241,15014702335,-21092829906
2013,Lithuania,Europe,928703415,762616464,-166086951
2013,Luxembourg,Europe,538404299,2033626678,1495222379
2013,Latvia,Europe,214637412,272457048,57819636
2013,Moldova,Europe,39347603,78228179,38880576
2013,North Macedonia,Europe,57032775,106006457,48973682
2013,Malta,Europe,248647015,409699533,161052518
2013,Montenegro,Europe,2007835,29509631,27501796
2013,Netherlands,Europe,19606212145,40450651508,20844439363
2013,Norway,Europe,6639802939,4121398061,-2518404878
2013,Poland,Europe,4889731092,4057798108,-831932984
2013,Portugal,Europe,2746167101,996778671,-1749388430
2013,Romania,Europe,1285862937,791335525,-494527412
2013,Russia,Europe,12612294547,11616253626,-996040921
2013,San Marino,Europe,6319570,1761637,-4557933
2013,Serbia,Europe,519478757,233863786,-285614971
2013,Slovakia,Europe,1591556106,510334756,-1081221350
2013,Slovenia,Europe,526519309,543484400,16965091
2013,Sweden,Europe,9697098238,4119701773,-5577396465
2013,Ukraine,Europe,1007375176,2117132315,1109757139
2013,Aruba,North America,35385135,1076663744,1041278609
2013,Anguilla,North America,3299391,26674990,23375599
2013,Antigua and Barbuda,North America,10591571,149403207,138811636
2013,Bahamas,North America,517268868,3184983775,2667714907
2013,Belize,North America,165665342,270488985,104823643
2013,Bermuda,North America,11476725,515315705,503838980
2013,Barbados,North America,87978180,518000103,430021923
2013,Canada,North America,3.31393E+11,2.63963E+11,-67429760649
2013,Costa Rica,North America,4513791858,7869273138,3355481280
2013,Curaçao,North America,376246858,648080789,271833931
2013,Cayman Islands,North America,7740353,502683140,494942787
2013,Dominica,North America,2085343,66085931,64000588
2013,Dominican Republic,North America,4373532641,6939950500,2566417859
2013,Grenada,North America,10168934,124560850,114391916
2013,Greenland,North America,9184192,10057115,872923
2013,Guatemala,North America,4163060610,6010524707,1847464097
2013,Honduras,North America,4614468265,5019256960,404788695
2013,Haiti,North America,860700088,794355484,-66344604
2013,Jamaica,North America,796900312,2005571844,1208671532
2013,Saint Kitts and Nevis,North America,45306664,157011199,111704535
2013,Saint Lucia,North America,54001190,516129563,462128373
2013,Saint Martin,North America,5208014,789337051,784129037
2013,Mexico,North America,2.91066E+11,2.05086E+11,-85979754096
2013,Montserrat,North America,1908651,24436187,22527536
2013,Nicaragua,North America,3194686014,1058212751,-2136473263
2013,Panama,North America,3479978669,9757681708,6277703039
2013,El Salvador,North America,2638423238,3402126717,763703479
2013,Saint Pierre and Miquelon,North America,57067,234826,177759
2013,Turks and Caicos Islands,North America,4322889,129574881,125251992
2013,Trinidad and Tobago,North America,6667591866,2299412878,-4368178988
2013,Saint Vincent and the Grenadines,North America,4787229,125528282,120741053
2013,British Virgin Islands,North America,5128563,161677911,156549348
2013,Australia,Oceania,8511270092,23619661026,15108390934
2013,Cook Islands,Oceania,369874,4210332,3840458
2013,Fiji,Oceania,223930772,129430227,-94500545
2013,Micronesia,Oceania,1658258,61718933,60060675
2013,Kiribati,Oceania,1089291,5307245,4217954
2013,Marshall Islands,Oceania,18240784,57755637,39514853
2013,New Caledonia,Oceania,68103036,116752120,48649084
2013,Norfolk Island,Oceania,7727,1561510,1553783
2013,Niue,Oceania,147133,237529,90396
2013,Nauru,Oceania,437890,715764,277874
2013,New Zealand,Oceania,3393622850,3052819225,-340803625
2013,Palau,Oceania,166402,44930479,44764077
2013,Papua New Guinea,Oceania,80277636,140625863,60348227
2013,French Polynesia,Oceania,24089389,160104020,136014631
2013,Solomon Islands,Oceania,9677651,8747089,-930562
2013,Tokelau,Oceania,677917,743937,66020
2013,Tonga,Oceania,2092449,23550809,21458360
2013,Tuvalu,Oceania,19800,532361,512561
2013,Vanuatu,Oceania,2449536,19656829,17207293
2013,Wallis and Futuna,Oceania,294781,574946,280165
2013,Samoa,Oceania,3498259,47202157,43703898
2013,Argentina,South America,4248993843,8550233591,4301239748
2013,Bolivia,South America,1288186508,1135913165,-152273343
2013,Brazil,South America,24884867315,37230434482,12345567167
2013,Chile,South America,9935506038,15797607571,5862101533
2013,Colombia,South America,18880586040,16952543566,-1928042474
2013,Ecuador,South America,11165825953,6978763883,-4187062070
2013,Falkland Islands,South America,13208797,1024067,-12184730
2013,Guyana,South America,399963209,362100991,-37862218
2013,Peru,South America,8150028696,8999879054,849850358
2013,Paraguay,South America,307404086,1353418566,1046014480
2013,Suriname,South America,321540131,531296352,209756221
2013,Uruguay,South America,399368559,1227879126,828510567
2013,Venezuela,South America,29174854704,12253260826,-16921593878
2014,Angola,Africa,3074959489,1900586284,-1174373205
2014,Burundi,Africa,4367214,9838893,5471679
2014,Benin,Africa,12320817,935596250,923275433
2014,Burkina Faso,Africa,10009909,93266278,83256369
2014,Botswana,Africa,255602131,109641217,-145960914
2014,Central African Republic,Africa,1438955,41050230,39611275
2014,Cote d'Ivoire,Africa,1218400387,348710884,-869689503
2014,Cameroon,Africa,205603658,313053176,107449518
2014,Democratic Republic of the Congo,Africa,135772660,169787674,34015014
2014,Republic of the Congo,Africa,560949834,322247497,-238702337
2014,Comoros,Africa,1436591,921145,-515446
2014,Cape Verde,Africa,1918275,12816349,10898074
2014,Djibouti,Africa,1467439,100012524,98545085
2014,Algeria,Africa,4562616800,2921092151,-1641524649
2014,Egypt,Africa,1738439081,6642232170,4903793089
2014,Eritrea,Africa,93953,5075948,4981995
2014,Ethiopia,Africa,173797378,533592723,359795345
2014,Gabon,Africa,730117944,409329253,-320788691
2014,Ghana,Africa,322195518,1298459080,976263562
2014,Guinea,Africa,118684538,64239893,-54444645
2014,Gambia,Africa,334350,40999860,40665510
2014,Guinea-Bissau,Africa,25611,2840900,2815289
2014,Equatorial Guinea,Africa,229484230,249779644,20295414
2014,Kenya,Africa,541554986,361114772,-180440214
2014,Liberia,Africa,82461288,170994732,88533444
2014,Libya,Africa,207656594,519824674,312168080
2014,Lesotho,Africa,343662378,19560242,-324102136
2014,Morocco,Africa,1060843775,2475430250,1414586475
2014,Madagascar,Africa,211822386,88476437,-123345949
2014,Mali,Africa,4204682,37156410,32951728
2014,Mozambique,Africa,95604040,386677234,291073194
2014,Mauritania,Africa,90403678,902445253,812041575
2014,Mauritius,Africa,309979943,77638526,-232341417
2014,Malawi,Africa,65867250,89237585,23370335
2014,Namibia,Africa,241009724,295393013,54383289
2014,Niger,Africa,80618939,106400345,25781406
2014,Nigeria,Africa,4478001370,5995629840,1517628470
2014,Rwanda,Africa,50639970,32081511,-18558459
2014,Sudan,Africa,13042660,135713935,122671275
2014,Senegal,Africa,37883889,205216553,167332664
2014,Saint Helena,Africa,8988395,443222,-8545173
2014,Sierra Leone,Africa,28777356,102928928,74151572
2014,Somalia,Africa,187728,33888415,33700687
2014,South Sudan,Africa,59695,45151929,45092234
2014,Sao Tome and Principe,Africa,919830,4670650,3750820
2014,Eswatini,Africa,82182030,36040359,-46141671
2014,Seychelles,Africa,4771980,16644750,11872770
2014,Chad,Africa,2112258995,64251382,-2048007613
2014,Togo,Africa,10455395,1033440600,1022985205
2014,Tunisia,Africa,498477101,915536481,417059380
2014,Tanzania,Africa,179663622,383601799,203938177
2014,Uganda,Africa,50705555,78435488,27729933
2014,South Africa,Africa,6897502500,6297894347,-599608153
2014,Zambia,Africa,61923205,166847059,104923854
2014,Zimbabwe,Africa,65945617,72283614,6337997
2014,French South Antarctic Territory,Antarctica,524245,7961951,7437706
2014,Afghanistan,Asia,10744025,589199527,578455502
2014,United Arab Emirates,Asia,2361131980,17708902803,15347770823
2014,Armenia,Asia,93494466,96750736,3256270
2014,Azerbaijan,Asia,763871759,448081923,-315789836
2014,Bangladesh,Asia,5459308179,732511159,-4726797020
2014,Bahrain,Asia,1131648553,870440179,-261208374
2014,Brunei,Asia,24739563,329153118,304413555
2014,Bhutan,Asia,236705,2370925,2134220
2014,Cocos (Keeling) Islands,Asia,3242373,5583209,2340836
2014,China,Asia,4.22238E+11,1.25013E+11,-2.97225E+11
2014,Christmas Island,Asia,1157208,129243,-1027965
2014,Cyprus,Asia,98301468,113744535,15443067
2014,Georgia,Asia,243834044,516590226,272756182
2014,Hong Kong,Asia,3709499626,37673072102,33963572476
2014,Indonesia,Asia,18289893998,6829729277,-11460164721
2014,India,Asia,43573122643,20843870611,-22729252032
2014,British Indian Ocean Territory,Asia,14024578,2024194,-12000384
2014,Iran,Asia,480227,208901362,208421135
2014,Iraq,Asia,12510031040,2036867921,-10473163119
2014,Israel,Asia,21630588564,11155399711,-10475188853
2014,Jordan,Asia,1140867905,1377323964,236456059
2014,Japan,Asia,1.26917E+11,64587148940,-62329838955
2014,Kazakhstan,Asia,708092347,1569255177,861162830
2014,Kyrgyzstan,Asia,3244804,186104797,182859993
2014,Cambodia,Asia,3621315156,433746761,-3187568395
2014,South Korea,Asia,71682485694,42369648638,-29312837056
2014,Kuwait,Asia,10374814861,3810695486,-6564119375
2014,Laos,Asia,43288854,43224602,-64252
2014,Lebanon,Asia,67086376,1304451496,1237365120
2014,Sri Lanka,Asia,2725120378,483990028,-2241130350
2014,Macau,Asia,60027580,291333913,231306333
2014,Maldives,Asia,13502473,35330930,21828457
2014,Burma,Asia,105968276,118533801,12565525
2014,Mongolia,Asia,23948412,210403564,186455152
2014,Malaysia,Asia,24316706661,10333969004,-13982737657
2014,Nepal,Asia,93025983,49267714,-43758269
2014,Oman,Asia,1055348048,1609936629,554588581
2014,Pakistan,Asia,3858769708,1542008025,-2316761683
2014,Philippines,Asia,9753137079,7668665895,-2084471184
2014,Palestine,Asia,11788239,43262281,31474042
2014,Qatar,Asia,1114531397,2453305241,1338773844
2014,Saudi Arabia,Asia,43269598393,19096388143,-24173210250
2014,Singapore,Asia,16185315314,28231696280,12046380966
2014,Syria,Asia,12230898,6761896,-5469002
2014,Thailand,Asia,25082215309,11027234785,-14054980524
2014,Tajikistan,Asia,3451109,14845308,11394199
2014,Turkmenistan,Asia,20601824,117404958,96803134
2014,Timor-Leste,Asia,180687,1160389,979702
2014,Turkey,Asia,7210246817,10580161062,3369914245
2014,Uzbekistan,Asia,11714811,147606873,135892062
2014,Vietnam,Asia,29494797539,5896131365,-23598666174
2014,Chinese Taipei,Asia,37605512060,24751683942,-12853828118
2014,Yemen,Asia,32027549,737337776,705310227
2014,Albania,Europe,56592271,73067539,16475268
2014,Andorra,Europe,602023,3733868,3131845
2014,Austria,Europe,10188174366,4369684625,-5818489741
2014,Belgium,Europe,16108038646,27068824730,10960786084
2014,Bulgaria,Europe,510423729,380718529,-129705200
2014,Bosnia and Herzegovina,Europe,78818483,238258824,159440341
2014,Belarus,Europe,164663608,96226032,-68437576
2014,Switzerland,Europe,29788200400,21552954940,-8235245460
2014,Czechia,Europe,4048505151,2712306808,-1336198343
2014,Germany,Europe,1.24788E+11,51443055624,-73345007040
2014,Denmark,Europe,7646281834,2521933818,-5124348016
2014,Spain,Europe,14368301050,11420486122,-2947814928
2014,Estonia,Europe,912421065,362117684,-550303381
2014,Finland,Europe,5511050497,2359568539,-3151481958
2014,France,Europe,36837671983,30586516843,-6251155140
2014,United Kingdom,Europe,57540150307,49567451475,-7972698832
2014,Gibraltar,Europe,140457,1825516210,1825375753
2014,Greece,Europe,1294203471,691872077,-602331394
2014,Croatia,Europe,343472258,381472193,37999935
2014,Hungary,Europe,4316707111,1872057057,-2444650054
2014,Ireland,Europe,29522020641,11673528405,-17848492236
2014,Iceland,Europe,264597827,440049388,175451561
2014,Italy,Europe,39629888595,15519447069,-24110441526
2014,Lithuania,Europe,1171642165,653855484,-517786681
2014,Luxembourg,Europe,554118984,1733097290,1178978306
2014,Latvia,Europe,193138098,242761350,49623252
2014,Moldova,Europe,49027647,69793277,20765630
2014,North Macedonia,Europe,151905207,121983135,-29922072
2014,Malta,Europe,236047688,823768136,587720448
2014,Montenegro,Europe,2972131,28627047,25654916
2014,Netherlands,Europe,22630600545,38937742310,16307141765
2014,Norway,Europe,5432903486,4609741208,-823162278
2014,Poland,Europe,4958128343,4011175544,-946952799
2014,Portugal,Europe,2960029513,1127861060,-1832168453
2014,Romania,Europe,1541501320,945317658,-596183662
2014,Russia,Europe,11653012210,14187709827,2534697617
2014,San Marino,Europe,6729438,4064857,-2664581
2014,Serbia,Europe,358213961,198798789,-159415172
2014,Slovakia,Europe,1758820974,639697132,-1119123842
2014,Slovenia,Europe,614012525,479911454,-134101071
2014,Sweden,Europe,10551099727,3926987099,-6624112628
2014,Ukraine,Europe,798928214,1477497470,678569256
2014,Aruba,North America,23873008,1268443814,1244570806
2014,Anguilla,North America,4790527,54026776,49236249
2014,Antigua and Barbuda,North America,5193353,204664142,199470789
2014,Bahamas,North America,483242516,3032549448,2549306932
2014,Belize,North America,122527569,272055983,149528414
2014,Bermuda,North America,10440985,536109618,525668633
2014,Barbados,North America,81477509,561335321,479857812
2014,Canada,North America,3.47475E+11,2.75784E+11,-71691035556
2014,Costa Rica,North America,4400536001,6984525968,2583989967
2014,Curaçao,North America,355195640,571276871,216081231
2014,Cayman Islands,North America,14534189,515019705,500485516
2014,Dominica,North America,1088995,53289486,52200491
2014,Dominican Republic,North America,4844463954,7793531147,2949067193
2014,Grenada,North America,8669189,105358892,96689703
2014,Greenland,North America,5507530,7723903,2216373
2014,Guatemala,North America,4132154057,6702308706,2570154649
2014,Honduras,North America,4387219906,5143968290,756748384
2014,Haiti,North America,918479880,853855634,-64624246
2014,Jamaica,North America,587171963,2093435665,1506263702
2014,Saint Kitts and Nevis,North America,47969294,191355999,143386705
2014,Saint Lucia,North America,69598545,487929474,418330929
2014,Saint Martin,North America,2702875,741351069,738648194
2014,Mexico,North America,3.058E+11,2.19766E+11,-86034348205
2014,Montserrat,North America,1502764,25290341,23787577
2014,Nicaragua,North America,2428621503,1045149159,-1383472344
2014,Panama,North America,2541679300,9478552040,6936872740
2014,El Salvador,North America,2488602929,3499724274,1011121345
2014,Turks and Caicos Islands,North America,4698887,163436930,158738043
2014,Trinidad and Tobago,North America,6534239698,2366031890,-4168207808
2014,Saint Vincent and the Grenadines,North America,2580023,125986265,123406242
2014,British Virgin Islands,North America,2656290,177264645,174608355
2014,Australia,Oceania,10190490513,23820812376,13630321863
2014,Cook Islands,Oceania,737177,4610268,3873091
2014,Fiji,Oceania,321001271,116664156,-204337115
2014,Micronesia,Oceania,375281,35263107,34887826
2014,Kiribati,Oceania,3210754,5573277,2362523
2014,Marshall Islands,Oceania,16024478,37545110,21520632
2014,New Caledonia,Oceania,91021504,141301765,50280261
2014,Norfolk Island,Oceania,14599,751055,736456
2014,Niue,Oceania,192221,105588,-86633
2014,Nauru,Oceania,413352,769105,355753
2014,New Zealand,Oceania,3942232645,4199392605,257159960
2014,Pitcairn Islands,Oceania,127218,33317,-93901
2014,Palau,Oceania,4796004,48205256,43409252
2014,Papua New Guinea,Oceania,96102218,118567380,22465162
2014,French Polynesia,Oceania,26778431,167110505,140332074
2014,Solomon Islands,Oceania,9347054,5545039,-3802015
2014,Tokelau,Oceania,713863,1073641,359778
2014,Tonga,Oceania,3744059,23268597,19524538
2014,Tuvalu,Oceania,75240,560427,485187
2014,Vanuatu,Oceania,7484557,12350959,4866402
2014,Wallis and Futuna,Oceania,32589,285099,252510
2014,Samoa,Oceania,5698706,39205845,33507139
2014,Argentina,South America,4187130882,9618786138,5431655256
2014,Bolivia,South America,2094511615,1138946244,-955565371
2014,Brazil,South America,27373950948,36004364316,8630413368
2014,Chile,South America,9397946996,14077215995,4679268999
2014,Colombia,South America,14718677777,18602375229,3883697452
2014,Ecuador,South America,11200837244,7549135644,-3651701600
2014,Falkland Islands,South America,19266231,7551402,-11714829
2014,Guyana,South America,392088609,401460926,9372317
2014,Peru,South America,6461790909,8956269882,2494478973
2014,Paraguay,South America,216549102,1551869937,1335320835
2014,Suriname,South America,411575454,568411102,156835648
2014,Uruguay,South America,473521814,1221793567,748271753
2014,Venezuela,South America,28018718560,10798217053,-17220501507
2015,Angola,Africa,2998003735,1352075948,-1645927787
2015,Burundi,Africa,8579939,10743645,2163706
2015,Benin,Africa,8541110,640079661,631538551
2015,Burkina Faso,Africa,2004611,125731241,123726630
2015,Botswana,Africa,182078856,69598578,-112480278
2015,Central African Republic,Africa,1311133,67215717,65904584
2015,Cote d'Ivoire,Africa,1063033657,353385798,-709647859
2015,Cameroon,Africa,142229916,231719642,89489726
2015,Democratic Republic of the Congo,Africa,154770970,581281543,426510573
2015,Republic of the Congo,Africa,350009612,750565804,400556192
2015,Comoros,Africa,1240347,1477156,236809
2015,Cape Verde,Africa,1922247,13159334,11237087
2015,Djibouti,Africa,2284994,126785914,124500920
2015,Algeria,Africa,2375362851,2105309454,-270053397
2015,Egypt,Africa,1731798711,4794108733,3062310022
2015,Eritrea,Africa,84410,3328650,3244240
2015,Ethiopia,Africa,240470253,627885138,387414885
2015,Gabon,Africa,307634492,198931960,-108702532
2015,Ghana,Africa,317787638,926965999,609178361
2015,Guinea,Africa,109058060,130290589,21232529
2015,Gambia,Africa,895564,46772340,45876776
2015,Guinea-Bissau,Africa,20694,2060061,2039367
2015,Equatorial Guinea,Africa,152469351,154397041,1927690
2015,Kenya,Africa,474220518,1161578706,687358188
2015,Liberia,Africa,44730290,125402745,80672455
2015,Libya,Africa,149510111,238992359,89482248
2015,Lesotho,Africa,246167743,5776224,-240391519
2015,Morocco,Africa,965345992,1996470379,1031124387
2015,Madagascar,Africa,260141185,109211043,-150930142
2015,Mali,Africa,3792633,69252780,65460147
2015,Mozambique,Africa,105400475,220806588,115406113
2015,Mauritania,Africa,1001000,883041430,882040430
2015,Mauritius,Africa,296985931,92366130,-204619801
2015,Malawi,Africa,59848291,54438231,-5410060
2015,Namibia,Africa,88629627,105733470,17103843
2015,Niger,Africa,143421132,126589183,-16831949
2015,Nigeria,Africa,2771923031,3469642254,697719223
2015,Rwanda,Africa,29365031,37804337,8439306
2015,Sudan,Africa,10252869,80577173,70324304
2015,Senegal,Africa,72599701,212035266,139435565
2015,Saint Helena,Africa,14828635,3620546,-11208089
2015,Sierra Leone,Africa,37664004,87043490,49379486
2015,Somalia,Africa,801811,43661058,42859247
2015,South Sudan,Africa,55742,16311783,16256041
2015,Sao Tome and Principe,Africa,706519,1626195,919676
2015,Eswatini,Africa,21797435,35704354,13906919
2015,Seychelles,Africa,10819805,24493137,13673332
2015,Chad,Africa,1207468552,54077106,-1153391446
2015,Togo,Africa,13350652,321251841,307901189
2015,Tunisia,Africa,497319722,689531583,192211861
2015,Tanzania,Africa,103122283,260288756,157166473
2015,Uganda,Africa,41609668,79730568,38120900
2015,South Africa,Africa,6241119570,5729568132,-511551438
2015,Zambia,Africa,48459409,137096947,88637538
2015,Zimbabwe,Africa,66787323,69561879,2774556
2015,French South Antarctic Territory,Antarctica,4795,7090405,7085610
2015,Afghanistan,Asia,17373194,389166734,371793540
2015,United Arab Emirates,Asia,2533949005,19431462821,16897513816
2015,Armenia,Asia,58189863,100951977,42762114
2015,Azerbaijan,Asia,221143133,354798660,133655527
2015,Bangladesh,Asia,6408546166,1006531163,-5402015003
2015,Bahrain,Asia,923581808,1077491541,153909733
2015,Brunei,Asia,57305096,262812854,205507758
2015,Bhutan,Asia,3168686,2420407,-748279
2015,Cocos (Keeling) Islands,Asia,3651471,513957,-3137514
2015,China,Asia,4.30326E+11,1.18104E+11,-3.12222E+11
2015,Christmas Island,Asia,1907050,1483723,-423327
2015,Cyprus,Asia,49889841,100650645,50760804
2015,Georgia,Asia,139876569,345360594,205484025
2015,Hong Kong,Asia,5124681908,33050734794,27926052886
2015,Indonesia,Asia,18519872278,6058496304,-12461375974
2015,India,Asia,41745710383,20456829478,-21288880905
2015,British Indian Ocean Territory,Asia,15621909,572656,-15049253
2015,Iran,Asia,21843516,304546832,282703316
2015,Iraq,Asia,4053545866,1553462351,-2500083515
2015,Israel,Asia,22309450364,10387599616,-11921850748
2015,Jordan,Asia,1628759708,1160916020,-467843688
2015,Japan,Asia,1.22514E+11,59782923145,-62731135754
2015,Kazakhstan,Asia,637496899,992503471,355006572
2015,Kyrgyzstan,Asia,15800872,93228795,77427923
2015,Cambodia,Asia,3767248758,436147241,-3331101517
2015,South Korea,Asia,71819477827,41170800132,-30648677695
2015,Kuwait,Asia,4226763566,2695534847,-1531228719
2015,Laos,Asia,49518681,37786149,-11732532
2015,Lebanon,Asia,81071317,1334492718,1253421401
2015,Sri Lanka,Asia,2824299754,435313965,-2388985789
2015,Macau,Asia,96012563,264838602,168826039
2015,Maldives,Asia,16679185,39756749,23077564
2015,Burma,Asia,172482871,168963668,-3519203
2015,Mongolia,Asia,27826694,102990417,75163723
2015,Malaysia,Asia,25078131835,11791089456,-13287042379
2015,Nepal,Asia,92413340,58900317,-33513023
2015,Oman,Asia,954288552,2100959093,1146670541
2015,Pakistan,Asia,3840721785,1978140988,-1862580797
2015,Philippines,Asia,9344003748,6996672825,-2347330923
2015,Palestine,Asia,11007306,45338332,34331026
2015,Qatar,Asia,1227031555,2403925931,1176894376
2015,Saudi Arabia,Asia,21105747734,17795378767,-3310368967
2015,Singapore,Asia,17304747800,26571022581,9266274781
2015,Syria,Asia,6194186,3064304,-3129882
2015,Thailand,Asia,26065302671,11802678193,-14262624478
2015,Tajikistan,Asia,32151547,17895255,-14256292
2015,Turkmenistan,Asia,54981448,78713805,23732357
2015,Timor-Leste,Asia,3227893,2569033,-658860
2015,Turkey,Asia,7115805154,9608101700,2492296546
2015,Uzbekistan,Asia,8684468,81136998,72452530
2015,Vietnam,Asia,35089296157,7022038963,-28067257194
2015,Chinese Taipei,Asia,37258715331,23012185323,-14246530008
2015,Yemen,Asia,54867172,302185102,247317930
2015,Albania,Europe,142733916,54120424,-88613492
2015,Andorra,Europe,4488097,3316319,-1171778
2015,Austria,Europe,10129435271,4561401916,-5568033355
2015,Belgium,Europe,16367729576,25655979503,9288249927
2015,Bulgaria,Europe,521318671,290352673,-230965998
2015,Bosnia and Herzegovina,Europe,74090574,173416335,99325761
2015,Belarus,Europe,146718281,239713021,92994740
2015,Switzerland,Europe,30317771394,20480859622,-9836911772
2015,Czechia,Europe,3793041565,2498865858,-1294175707
2015,Germany,Europe,1.23629E+11,52123398790,-71505982488
2015,Denmark,Europe,7878692550,2073518850,-5805173700
2015,Spain,Europe,13019734896,11830758236,-1188976660
2015,Estonia,Europe,655008438,297436059,-357572379
2015,Finland,Europe,4669350561,1619159093,-3050191468
2015,France,Europe,36584117610,29049181497,-7534936113
2015,United Kingdom,Europe,60739412231,52209841722,-8529570509
2015,Gibraltar,Europe,230642,1458114596,1457883954
2015,Greece,Europe,1612012930,702959656,-909053274
2015,Croatia,Europe,374745024,357291507,-17453517
2015,Hungary,Europe,4065221780,1767643085,-2297578695
2015,Ireland,Europe,33674047546,11758485296,-21915562250
2015,Iceland,Europe,294890277,371909735,77019458
2015,Italy,Europe,40108583057,14978079108,-25130503949
2015,Lithuania,Europe,1107294253,501802212,-605492041
2015,Luxembourg,Europe,562992454,1873706522,1310714068
2015,Latvia,Europe,214978794,176523745,-38455049
2015,Moldova,Europe,38753018,43806533,5053515
2015,North Macedonia,Europe,184124567,80442332,-103682235
2015,Malta,Europe,177650391,371871654,194221263
2015,Montenegro,Europe,2427266,20676320,18249054
2015,Netherlands,Europe,17929529112,37321616924,19392087812
2015,Norway,Europe,4733314675,4006253331,-727061344
2015,Poland,Europe,4725500868,3785152895,-940347973
2015,Portugal,Europe,2994617643,1028382358,-1966235285
2015,Romania,Europe,1397877355,754979183,-642898172
2015,Russia,Europe,15691262710,8454279540,-7236983170
2015,San Marino,Europe,8858359,1314055,-7544304
2015,Serbia,Europe,290819549,226314864,-64504685
2015,Slovakia,Europe,1757350520,586864541,-1170485979
2015,Slovenia,Europe,585400653,486699591,-98701062
2015,Sweden,Europe,10248340418,3679790856,-6568549562
2015,Ukraine,Europe,665956643,1094910730,428954087
2015,Aruba,North America,36544794,1090757642,1054212848
2015,Anguilla,North America,5009661,41145755,36136094
2015,Antigua and Barbuda,North America,8377281,468693955,460316674
2015,Bahamas,North America,375406954,2241462137,1866055183
2015,Belize,North America,124500281,316958493,192458212
2015,Bermuda,North America,7141770,556393248,549251478
2015,Barbados,North America,162204699,608393239,446188540
2015,Canada,North America,2.9461E+11,2.44843E+11,-49767812373
2015,Costa Rica,North America,4015213548,5772219473,1757005925
2015,Curaçao,North America,319979959,484641524,164661565
2015,Cayman Islands,North America,85003220,518427797,433424577
2015,Dominica,North America,1340113,54988608,53648495
2015,Dominican Republic,North America,4845681396,6998031125,2152349729
2015,Grenada,North America,8082187,108786820,100704633
2015,Greenland,North America,2531504,8349854,5818350
2015,Guatemala,North America,3979779196,6087209068,2107429872
2015,Honduras,North America,3878777710,4726404764,847627054
2015,Haiti,North America,962153339,711582704,-250570635
2015,Jamaica,North America,453325911,1696438354,1243112443
2015,Saint Kitts and Nevis,North America,43574028,160569629,116995601
2015,Saint Lucia,North America,86297102,501591299,415294197
2015,Saint Martin,North America,1742233,702828763,701086530
2015,Mexico,North America,3.00161E+11,2.13812E+11,-86349457736
2015,Montserrat,North America,725585,5340586,4615001
2015,Nicaragua,North America,2611207095,1201369801,-1409837294
2015,Panama,North America,1885721074,6766871926,4881150852
2015,El Salvador,North America,2699612960,3183861096,484248136
2015,Saint Pierre and Miquelon,North America,184182,208490,24308
2015,Turks and Caicos Islands,North America,4975882,162763350,157787468
2015,Trinidad and Tobago,North America,4568985893,2774978211,-1794007682
2015,Saint Vincent and the Grenadines,North America,2848987,117904205,115055218
2015,British Virgin Islands,North America,5325150,160177766,154852616
2015,Australia,Oceania,10102334623,22513894779,12411560156
2015,Cook Islands,Oceania,701551,3585626,2884075
2015,Fiji,Oceania,258604061,60858008,-197746053
2015,Micronesia,Oceania,611432,33852849,33241417
2015,Kiribati,Oceania,3442705,5504655,2061950
2015,Marshall Islands,Oceania,12781940,44347685,31565745
2015,New Caledonia,Oceania,45503761,106197098,60693337
2015,Norfolk Island,Oceania,1176071,309674,-866397
2015,Niue,Oceania,144740,67227,-77513
2015,Nauru,Oceania,503437,1299861,796424
2015,New Zealand,Oceania,4117617657,3629503150,-488114507
2015,Palau,Oceania,2516301,51052637,48536336
2015,Papua New Guinea,Oceania,87519077,177880242,90361165
2015,French Polynesia,Oceania,30595894,145948705,115352811
2015,Solomon Islands,Oceania,3830223,4930998,1100775
2015,Tokelau,Oceania,346049,148475,-197574
2015,Tonga,Oceania,3171407,11351932,8180525
2015,Tuvalu,Oceania,213880,587828,373948
2015,Vanuatu,Oceania,3905730,3627823,-277907
2015,Wallis and Futuna,Oceania,95134,330455,235321
2015,Samoa,Oceania,4759526,36447672,31688146
2015,Argentina,South America,3515880790,8299428209,4783547419
2015,Bolivia,South America,1132672251,939405232,-193267019
2015,Brazil,South America,24348571031,26664450097,2315879066
2015,Chile,South America,8328432195,11860957172,3532524977
2015,Colombia,South America,10236513442,15650984688,5414471246
2015,Ecuador,South America,7265750280,5197858464,-2067891816
2015,Falkland Islands,South America,12498256,2141997,-10356259
2015,Guyana,South America,358336003,381723730,23387727
2015,Peru,South America,5107685089,7920037738,2812352649
2015,Paraguay,South America,158668344,1279507404,1120839060
2015,Suriname,South America,140846206,478171170,337324964
2015,Uruguay,South America,579290525,1047836545,468546020
2015,Venezuela,South America,14696460674,8095631468,-6600829206
2016,Angola,Africa,2370220359,1047929118,-1322291241
2016,Burundi,Africa,7606807,12556128,4949321
2016,Benin,Africa,11832887,242001932,230169045
2016,Burkina Faso,Africa,3274067,161346581,158072514
2016,Botswana,Africa,227102075,46621140,-180480935
2016,Central African Republic,Africa,927369,40389188,39461819
2016,Cote d'Ivoire,Africa,1129168539,318110571,-811057968
2016,Cameroon,Africa,149291206,202671555,53380349
2016,Democratic Republic of the Congo,Africa,177474788,420835773,243360985
2016,Republic of the Congo,Africa,125006202,952657710,827651508
2016,Comoros,Africa,2652880,1634903,-1017977
2016,Cape Verde,Africa,3857322,14367628,10510306
2016,Djibouti,Africa,1021941,115462838,114440897
2016,Algeria,Africa,3813787774,2348103696,-1465684078
2016,Egypt,Africa,1708249330,3428583913,1720334583
2016,Eritrea,Africa,439960,2936878,2496918
2016,Ethiopia,Africa,228819457,1241256671,1012437214
2016,Gabon,Africa,99881695,74861419,-25020276
2016,Ghana,Africa,331548579,1036274178,704725599
2016,Guinea,Africa,13360903,96393989,83033086
2016,Gambia,Africa,395116,39034205,38639089
2016,Guinea-Bissau,Africa,102879,3402416,3299537
2016,Equatorial Guinea,Africa,185857360,273751262,87893902
2016,Kenya,Africa,466718644,447544059,-19174585
2016,Liberia,Africa,43993091,145570998,101577907
2016,Libya,Africa,744229270,184395873,-559833397
2016,Lesotho,Africa,307374322,6403257,-300971065
2016,Morocco,Africa,950456095,2229997536,1279541441
2016,Madagascar,Africa,335701432,96754679,-238946753
2016,Mali,Africa,10962040,111826269,100864229
2016,Mozambique,Africa,149741958,187828887,38086929
2016,Mauritania,Africa,46523524,256647584,210124060
2016,Mauritius,Africa,268364532,90919998,-177444534
2016,Malawi,Africa,68854384,48887308,-19967076
2016,Namibia,Africa,111304505,150081446,38776941
2016,Niger,Africa,38271269,130347191,92075922
2016,Nigeria,Africa,4069586076,2204713965,-1864872111
2016,Rwanda,Africa,29058291,51772311,22714020
2016,Sudan,Africa,15428978,73256395,57827417
2016,Senegal,Africa,69658638,198693495,129034857
2016,Saint Helena,Africa,15189015,729010,-14460005
2016,Sierra Leone,Africa,30221964,94940849,64718885
2016,Somalia,Africa,984356,35522483,34538127
2016,South Sudan,Africa,124282,8582316,8458034
2016,Sao Tome and Principe,Africa,404261,3081618,2677357
2016,Eswatini,Africa,20950570,27511533,6560963
2016,Seychelles,Africa,6730109,18326387,11596278
2016,Chad,Africa,856817389,27247622,-829569767
2016,Togo,Africa,11335213,235686688,224351475
2016,Tunisia,Africa,369947479,624128486,254181007
2016,Tanzania,Africa,138344417,202664170,64319753
2016,Uganda,Africa,46861886,70227154,23365268
2016,South Africa,Africa,5848470121,4680739100,-1167731021
2016,Zambia,Africa,41152101,109173552,68021451
2016,Zimbabwe,Africa,24597221,63885211,39287990
2016,French South Antarctic Territory,Antarctica,72978,4855579,4782601
2016,Afghanistan,Asia,17408284,865852291,848444007
2016,United Arab Emirates,Asia,3663595287,18670808171,15007212884
2016,Armenia,Asia,44895378,69592155,24696777
2016,Azerbaijan,Asia,84017645,302126589,218108944
2016,Bangladesh,Asia,6097573402,881334017,-5216239385
2016,Bahrain,Asia,1125743862,1135548667,9804805
2016,Brunei,Asia,12208193,177606715,165398522
2016,Bhutan,Asia,4048957,1873951,-2175006
2016,Cocos (Keeling) Islands,Asia,2100118,722308,-1377810
2016,China,Asia,4.06163E+11,1.1432E+11,-2.91842E+11
2016,Christmas Island,Asia,1634703,1092844,-541859
2016,Cyprus,Asia,77702705,166767872,89065167
2016,Georgia,Asia,95583776,270563213,174979437
2016,Hong Kong,Asia,6097468430,32220117432,26122649002
2016,Indonesia,Asia,18353420452,6171541847,-12181878605
2016,India,Asia,43437995291,20552390770,-22885604521
2016,British Indian Ocean Territory,Asia,11801635,4922003,-6879632
2016,Iran,Asia,87661518,243386454,155724936
2016,Iraq,Asia,5684596973,1184895797,-4499701176
2016,Israel,Asia,20589887516,8143658308,-12446229208
2016,Jordan,Asia,1827348641,1162774301,-664574340
2016,Japan,Asia,1.2565E+11,61382927586,-64266691770
2016,Kazakhstan,Asia,807154742,1342528321,535373579
2016,Kyrgyzstan,Asia,3199383,132480756,129281373
2016,Cambodia,Asia,3339964197,381944789,-2958019408
2016,South Korea,Asia,68433562279,40210475407,-28223086872
2016,Kuwait,Asia,3081421042,2870210961,-211210081
2016,Laos,Asia,56891597,38969539,-17922058
2016,Lebanon,Asia,79567883,1236241940,1156674057
2016,Sri Lanka,Asia,2805261876,491114642,-2314147234
2016,Macau,Asia,76513590,337365164,260851574
2016,Maldives,Asia,17620834,40050909,22430075
2016,Burma,Asia,320113287,223127206,-96986081
2016,Mongolia,Asia,12845954,126179682,113333728
2016,Malaysia,Asia,25269892356,11671360853,-13598531503
2016,Nepal,Asia,106332274,65720043,-40612231
2016,Oman,Asia,968167719,1754994476,786826757
2016,Pakistan,Asia,3801668255,2172754822,-1628913433
2016,Philippines,Asia,10340805581,7381335109,-2959470472
2016,Palestine,Asia,11332114,51271156,39939042
2016,Qatar,Asia,1034080443,3779160557,2745080114
2016,Saudi Arabia,Asia,16463572328,14607035167,-1856537161
2016,Singapore,Asia,16805141757,24189004726,7383862969
2016,Syria,Asia,6727510,3490887,-3236623
2016,Thailand,Asia,26482799250,10539310445,-15943488805
2016,Tajikistan,Asia,685021,32174330,31489309
2016,Turkmenistan,Asia,18175277,43508171,25332894
2016,Timor-Leste,Asia,5387965,1462039,-3925926
2016,Turkey,Asia,7339346931,9580111148,2240764217
2016,Uzbekistan,Asia,30239157,42142132,11902975
2016,Vietnam,Asia,40409793980,8611030840,-31798763140
2016,Chinese Taipei,Asia,35976679798,25181928926,-10794750872
2016,Yemen,Asia,2370431,169032377,166661946
2016,Albania,Europe,114253544,79574029,-34679515
2016,Andorra,Europe,6429045,2867245,-3561800
2016,Austria,Europe,9815103347,4234148036,-5580955311
2016,Belgium,Europe,17875802200,26573010245,8697208045
2016,Bulgaria,Europe,499118887,254697542,-244421345
2016,Bosnia and Herzegovina,Europe,61308942,138998949,77690007
2016,Belarus,Europe,148977581,286988191,138010610
2016,Switzerland,Europe,36173080562,23706966497,-12466114065
2016,Czechia,Europe,3618586512,2411643357,-1206943155
2016,Germany,Europe,1.1557E+11,50665012998,-64904780754
2016,Denmark,Europe,7948333446,2156980076,-5791353370
2016,Spain,Europe,13122858421,12124428195,-998430226
2016,Estonia,Europe,620628548,323679411,-296949137
2016,Finland,Europe,4880867485,1670058308,-3210809177
2016,France,Europe,36298234347,29035282781,-7262951566
2016,United Kingdom,Europe,54421198460,49445585911,-4975612549
2016,Gibraltar,Europe,131411,1170496988,1170365577
2016,Greece,Europe,1355143822,778085477,-577058345
2016,Croatia,Europe,551630026,327450972,-224179054
2016,Hungary,Europe,4021388675,1860035949,-2161352726
2016,Ireland,Europe,40813072260,14324190419,-26488881841
2016,Iceland,Europe,359241515,518898294,159656779
2016,Italy,Europe,39332463264,15123565946,-24208897318
2016,Lithuania,Europe,1263228269,411368882,-851859387
2016,Luxembourg,Europe,523083968,1690223077,1167139109
2016,Latvia,Europe,233017481,191767828,-41249653
2016,Moldova,Europe,33940225,45392366,11452141
2016,North Macedonia,Europe,66360750,123560206,57199456
2016,Malta,Europe,1078527760,319893923,-758633837
2016,Montenegro,Europe,1856494,30150686,28294192
2016,Netherlands,Europe,17125488189,35907691062,18782202873
2016,Norway,Europe,3983142937,3580038055,-403104882
2016,Poland,Europe,4886076242,4050328542,-835747700
2016,Portugal,Europe,2894327821,1001414429,-1892913392
2016,Romania,Europe,1235246091,691273909,-543972182
2016,Russia,Europe,10835423111,8156109010,-2679314101
2016,San Marino,Europe,5777012,2338357,-3438655
2016,Serbia,Europe,314818405,235063609,-79754796
2016,Slovakia,Europe,2057295739,558231525,-1499064214
2016,Slovenia,Europe,622029485,501411834,-120617651
2016,Sweden,Europe,9620108447,3553389504,-6066718943
2016,Ukraine,Europe,520678938,1249550426,728871488
2016,Aruba,North America,5160000,758937521,753777521
2016,Anguilla,North America,3115118,36729482,33614364
2016,Antigua and Barbuda,North America,11145289,230219158,219073869
2016,Bahamas,North America,280549351,1938872549,1658323198
2016,Belize,North America,93977249,296357111,202379862
2016,Bermuda,North America,9943568,605665950,595722382
2016,Barbados,North America,182520319,540620325,358100006
2016,Canada,North America,2.75697E+11,2.33315E+11,-42382724308
2016,Costa Rica,North America,4133256572,5616945888,1483689316
2016,Curaçao,North America,257327859,824240315,566912456
2016,Cayman Islands,North America,74832276,572852925,498020649
2016,Dominica,North America,1994641,45879307,43884666
2016,Dominican Republic,North America,4838267821,7448754425,2610486604
2016,Grenada,North America,8488549,109425617,100937068
2016,Greenland,North America,5416704,6377524,960820
2016,Guatemala,North America,3856529064,6120586041,2264056977
2016,Honduras,North America,4268449285,4159918071,-108531214
2016,Haiti,North America,906401433,702618926,-203782507
2016,Jamaica,North America,475477070,1711587493,1236110423
2016,Saint Kitts and Nevis,North America,39864484,180528126,140663642
2016,Saint Lucia,North America,47257427,370253010,322995583
2016,Saint Martin,North America,1830382,677028122,675197740
2016,Mexico,North America,2.91977E+11,2.0807E+11,-83907366611
2016,Montserrat,North America,557640,7683189,7125549
2016,Nicaragua,North America,2655474345,1551135979,-1104338366
2016,Panama,North America,2130450599,5459590900,3329140301
2016,El Salvador,North America,2699252233,2995978666,296726433
2016,Saint Pierre and Miquelon,North America,152716,36562,-116154
2016,Turks and Caicos Islands,North America,3872985,172549343,168676358
2016,Trinidad and Tobago,North America,2813154371,2125734248,-687420123
2016,Saint Vincent and the Grenadines,North America,3315019,125511421,122196402
2016,British Virgin Islands,North America,4161583,161111339,156949756
2016,Australia,Oceania,8568005492,20911892478,12343886986
2016,Cook Islands,Oceania,1490449,3762797,2272348
2016,Fiji,Oceania,287994791,62691018,-225303773
2016,Micronesia,Oceania,540092,36197362,35657270
2016,Kiribati,Oceania,3914069,3997099,83030
2016,Marshall Islands,Oceania,10904824,244930874,234026050
2016,New Caledonia,Oceania,42716724,51782446,9065722
2016,Norfolk Island,Oceania,275182,111396,-163786
2016,Niue,Oceania,863603,72436,-791167
2016,Nauru,Oceania,970540,450681,-519859
2016,New Zealand,Oceania,3736688996,3471813093,-264875903
2016,Palau,Oceania,1274792,56043634,54768842
2016,Papua New Guinea,Oceania,84474600,88069617,3595017
2016,French Polynesia,Oceania,22981843,143855809,120873966
2016,Solomon Islands,Oceania,3399320,8863380,5464060
2016,Tokelau,Oceania,1911377,2044242,132865
2016,Tonga,Oceania,4234845,12333015,8098170
2016,Tuvalu,Oceania,13092,1080555,1067463
2016,Vanuatu,Oceania,5690255,3872480,-1817775
2016,Wallis and Futuna,Oceania,188936,164563,-24373
2016,Samoa,Oceania,6237214,37516853,31279639
2016,Argentina,South America,4679434325,7553090526,2873656201
2016,Bolivia,South America,1020761100,713721697,-307039403
2016,Brazil,South America,24774404820,25573083694,798678874
2016,Chile,South America,8619934303,10337905239,1717970936
2016,Colombia,South America,10381975217,12344555569,1962580352
2016,Ecuador,South America,5501119342,4040671311,-1460448031
2016,Falkland Islands,South America,19099158,1374551,-17724607
2016,Guyana,South America,347353231,411487230,64133999
2016,Peru,South America,6374105644,7306303124,932197480
2016,Paraguay,South America,217193878,1316016778,1098822900
2016,Suriname,South America,59680268,296400836,236720568
2016,Uruguay,South America,482211907,720117332,237905425
2016,Venezuela,South America,10489540869,5041739551,-5447801318
2017,Angola,Africa,2767001565,880068356,-1886933209
2017,Burundi,Africa,8158540,23624346,15465806
2017,Benin,Africa,22862924,282041792,259178868
2017,Burkina Faso,Africa,4730008,167983091,163253083
2017,Botswana,Africa,143290058,80718551,-62571507
2017,Central African Republic,Africa,2124540,18668922,16544382
2017,Cote d'Ivoire,Africa,1222092958,373604939,-848488019
2017,Cameroon,Africa,127580937,186376483,58795546
2017,Democratic Republic of the Congo,Africa,82114172,1412859033,1330744861
2017,Republic of the Congo,Africa,319064509,129637420,-189427089
2017,Comoros,Africa,4804547,1530288,-3274259
2017,Cape Verde,Africa,3428069,12898001,9469932
2017,Djibouti,Africa,4073935,127594787,123520852
2017,Algeria,Africa,3514581973,1369503422,-2145078551
2017,Egypt,Africa,1931645110,3616933789,1685288679
2017,Eritrea,Africa,265684,4686598,4420914
2017,Ethiopia,Africa,281595979,1073670974,792074995
2017,Gabon,Africa,183717736,86834300,-96883436
2017,Ghana,Africa,736470807,1009362385,272891578
2017,Guinea,Africa,21110172,89806036,68695864
2017,Gambia,Africa,957340,40189614,39232274
2017,Guinea-Bissau,Africa,15705,3673175,3657470
2017,Equatorial Guinea,Africa,324709426,109217073,-215492353
2017,Kenya,Africa,472755237,449109631,-23645606
2017,Liberia,Africa,64095946,129528994,65433048
2017,Libya,Africa,749309337,128337548,-620971789
2017,Lesotho,Africa,320283280,8030740,-312252540
2017,Morocco,Africa,1164744814,2650602782,1485857968
2017,Madagascar,Africa,592556165,90585109,-501971056
2017,Mali,Africa,12433916,107472415,95038499
2017,Mozambique,Africa,161395723,200563361,39167638
2017,Mauritania,Africa,54638970,145335417,90696447
2017,Mauritius,Africa,237594807,115492208,-122102599
2017,Malawi,Africa,49007245,53658863,4651618
2017,Namibia,Africa,129520300,114711867,-14808433
2017,Niger,Africa,40089857,210783745,170693888
2017,Nigeria,Africa,7546071474,2548217074,-4997854400
2017,Rwanda,Africa,54322195,46532340,-7789855
2017,Sudan,Africa,16506060,111481795,94975735
2017,Senegal,Africa,98872796,214965053,116092257
2017,Saint Helena,Africa,13085861,563387,-12522474
2017,Sierra Leone,Africa,31089571,83752223,52662652
2017,Somalia,Africa,974747,66651144,65676397
2017,South Sudan,Africa,277940,11387079,11109139
2017,Sao Tome and Principe,Africa,557234,4316775,3759541
2017,Eswatini,Africa,19548022,27313393,7765371
2017,Seychelles,Africa,17040725,20614208,3573483
2017,Chad,Africa,476817060,26079088,-450737972
2017,Togo,Africa,14322118,455150823,440828705
2017,Tunisia,Africa,417487566,610239209,192751643
2017,Tanzania,Africa,117795065,184393239,66598174
2017,Uganda,Africa,60026009,113830578,53804569
2017,South Africa,Africa,6929994972,5158627884,-1771367088
2017,Zambia,Africa,49031269,112402919,63371650
2017,Zimbabwe,Africa,48051899,46779721,-1272178
2017,French South Antarctic Territory,Antarctica,114969,2831658,2716689
2017,Afghanistan,Asia,11770291,885134576,873364285
2017,United Arab Emirates,Asia,5209183813,20059930564,14850746751
2017,Armenia,Asia,67737478,105460386,37722908
2017,Azerbaijan,Asia,66493429,227887835,161394406
2017,Bangladesh,Asia,5839194143,1422506350,-4416687793
2017,Bahrain,Asia,870714072,870323005,-391067
2017,Brunei,Asia,26807718,216402577,189594859
2017,Bhutan,Asia,1110836,34826842,33716006
2017,Cocos (Keeling) Islands,Asia,1020608,362557,-658051
2017,China,Asia,4.5889E+11,1.27499E+11,-3.31391E+11
2017,Christmas Island,Asia,1288172,453330,-834842
2017,Cyprus,Asia,56305576,98746553,42440977
2017,Georgia,Asia,148267925,401711449,253443524
2017,Hong Kong,Asia,5289173527,36740825313,31451651786
2017,Indonesia,Asia,19394254677,7081863817,-12312390860
2017,India,Asia,46772950433,24481473220,-22291477213
2017,British Indian Ocean Territory,Asia,8455803,35813360,27357557
2017,Iran,Asia,65431214,186637879,121206665
2017,Iraq,Asia,9834119622,1038649054,-8795470568
2017,Israel,Asia,19770066056,7839364919,-11930701137
2017,Jordan,Asia,1879956598,1515163883,-364792715
2017,Japan,Asia,1.29235E+11,65097501307,-64137918257
2017,Kazakhstan,Asia,448056831,820073749,372016918
2017,Kyrgyzstan,Asia,6805526,122155928,115350402
2017,Cambodia,Asia,3474558127,416852613,-3057705514
2017,South Korea,Asia,69581891369,47616937111,-21964954258
2017,Kuwait,Asia,2607095037,3695717332,1088622295
2017,Laos,Asia,95551525,43151254,-52400271
2017,Lebanon,Asia,89286064,1380070446,1290784382
2017,Sri Lanka,Asia,2958693221,747957207,-2210736014
2017,Macau,Asia,56800078,176182464,119382386
2017,Maldives,Asia,19927977,39790613,19862636
2017,Burma,Asia,461560341,579871403,118311062
2017,Mongolia,Asia,11864141,158449240,146585099
2017,Malaysia,Asia,27939065413,12034175579,-15904889834
2017,Nepal,Asia,105021935,65085003,-39936932
2017,Oman,Asia,756749315,1273072128,516322813
2017,Pakistan,Asia,3769920795,2809187577,-960733218
2017,Philippines,Asia,13196732461,8894497995,-4302234466
2017,Palestine,Asia,12715519,50137330,37421811
2017,Qatar,Asia,978486649,4280401390,3301914741
2017,Saudi Arabia,Asia,17733796514,13670541678,-4063254836
2017,Singapore,Asia,20551295363,28003056207,7451760844
2017,Syria,Asia,6889760,6780911,-108849
2017,Thailand,Asia,28511573429,12251807426,-16259766003
2017,Tajikistan,Asia,16033395,25626489,9593094
2017,Turkmenistan,Asia,13704336,134735371,121031035
2017,Timor-Leste,Asia,10621164,8942670,-1678494
2017,Turkey,Asia,9259961155,10644250630,1384289475
2017,Uzbekistan,Asia,10964575,151702607,140738032
2017,Vietnam,Asia,45123166786,10665898883,-34457267903
2017,Chinese Taipei,Asia,39192894477,26267375573,-12925518904
2017,Yemen,Asia,9252703,195222774,185970071
2017,Albania,Europe,38035200,60860296,22825096
2017,Andorra,Europe,13593187,3269235,-10323952
2017,Austria,Europe,10767634002,4921180174,-5846453828
2017,Belgium,Europe,15653428815,25670891120,10017462305
2017,Bulgaria,Europe,545922773,342795378,-203127395
2017,Bosnia and Herzegovina,Europe,90164935,285119946,194955011
2017,Belarus,Europe,247004680,246663314,-341366
2017,Switzerland,Europe,35217036995,21016042420,-14200994575
2017,Czechia,Europe,3751115903,3020186825,-730929078
2017,Germany,Europe,1.22845E+11,53558535093,-69286083079
2017,Denmark,Europe,7747052340,2144813487,-5602238853
2017,Spain,Europe,14833759787,13551236513,-1282523274
2017,Estonia,Europe,558616880,283039920,-275576960
2017,Finland,Europe,4774801506,1707716639,-3067084867
2017,France,Europe,38719273740,30438109129,-8281164611
2017,United Kingdom,Europe,54124580771,47199412415,-6925168356
2017,Gibraltar,Europe,571119,846124275,845553156
2017,Greece,Europe,1330761333,854141952,-476619381
2017,Croatia,Europe,626439034,469828376,-156610658
2017,Hungary,Europe,3552355915,1957111349,-1595244566
2017,Ireland,Europe,43940028603,16081761151,-27858267452
2017,Iceland,Europe,376642624,368644849,-7997775
2017,Italy,Europe,45913617922,16511182047,-29402435875
2017,Lithuania,Europe,1503023019,504405347,-998617672
2017,Luxembourg,Europe,516162679,1291287909,775125230
2017,Latvia,Europe,391280828,261717580,-129563248
2017,Moldova,Europe,32561120,59248500,26687380
2017,North Macedonia,Europe,225945204,160970641,-64974563
2017,Malta,Europe,161037421,240338381,79300960
2017,Montenegro,Europe,3392354,22116636,18724282
2017,Netherlands,Europe,19466711090,39097439670,19630728580
2017,Norway,Europe,5018821348,4711191151,-307630197
2017,Poland,Europe,6254418372,4944044330,-1310374042
2017,Portugal,Europe,3345969107,1118093051,-2227876056
2017,Romania,Europe,1553320488,1243821092,-309499396
2017,Russia,Europe,12704105982,9083483050,-3620622932
2017,San Marino,Europe,4528628,2016652,-2511976
2017,Serbia,Europe,275792749,217241484,-58551265
2017,Slovakia,Europe,2582548534,691009555,-1891538979
2017,Slovenia,Europe,664162006,766169658,102007652
2017,Sweden,Europe,10163158544,3684018705,-6479139839
2017,Ukraine,Europe,946433022,1928332993,981899971
2017,Aruba,North America,9245967,921889366,912643399
2017,Anguilla,North America,3895774,48815830,44920056
2017,Antigua and Barbuda,North America,11222547,343847612,332625065
2017,Bahamas,North America,413886459,2842032018,2428145559
2017,Belize,North America,88219705,303839937,215620232
2017,Bermuda,North America,10888520,548067973,537179453
2017,Barbados,North America,128342051,562453612,434111561
2017,Canada,North America,2.92337E+11,2.46485E+11,-45852613033
2017,Costa Rica,North America,4670490967,5859452457,1188961490
2017,Curaçao,North America,143051173,651951868,508900695
2017,Cayman Islands,North America,15482042,657277476,641795434
2017,Dominica,North America,951778,131284418,130332640
2017,Dominican Republic,North America,4642068911,7803517747,3161448836
2017,Grenada,North America,9525894,134420274,124894380
2017,Greenland,North America,9534271,9570666,36395
2017,Guatemala,North America,4142685813,6821954671,2679268858
2017,Honduras,North America,4379786606,4575988647,196202041
2017,Haiti,North America,932365703,931158884,-1206819
2017,Jamaica,North America,512431870,2219729308,1707297438
2017,Saint Kitts and Nevis,North America,35117665,192181583,157063918
2017,Saint Lucia,North America,45748378,411425164,365676786
2017,Saint Martin,North America,1444761,516831335,515386574
2017,Mexico,North America,3.20639E+11,2.25691E+11,-94947189380
2017,Montserrat,North America,602450,7522620,6920170
2017,Nicaragua,North America,2977578642,1527482888,-1450095754
2017,Panama,North America,1636366815,5723140389,4086773574
2017,El Salvador,North America,2701958258,3125259382,423301124
2017,Saint Pierre and Miquelon,North America,13491,354994,341503
2017,Turks and Caicos Islands,North America,3389237,206108071,202718834
2017,Trinidad and Tobago,North America,3107546244,1594473188,-1513073056
2017,Saint Vincent and the Grenadines,North America,5368272,113890160,108521888
2017,British Virgin Islands,North America,4024450,259838950,255814500
2017,Australia,Oceania,9063872145,22894321154,13830449009
2017,Cook Islands,Oceania,3377373,4282259,904886
2017,Fiji,Oceania,315961022,64101528,-251859494
2017,Micronesia,Oceania,693873,36144176,35450303
2017,Kiribati,Oceania,4152947,4108265,-44682
2017,Marshall Islands,Oceania,9700734,491886451,482185717
2017,New Caledonia,Oceania,64992392,45871819,-19120573
2017,Norfolk Island,Oceania,256053,125924,-130129
2017,Niue,Oceania,190485,79898,-110587
2017,Nauru,Oceania,1432985,192308,-1240677
2017,New Zealand,Oceania,3827507465,3651496247,-176011218
2017,Palau,Oceania,1065963,50717698,49651735
2017,Papua New Guinea,Oceania,113670327,84177096,-29493231
2017,French Polynesia,Oceania,29235182,158683436,129448254
2017,Solomon Islands,Oceania,5256158,9884070,4627912
2017,Tokelau,Oceania,1912513,1457101,-455412
2017,Tonga,Oceania,4128648,13318903,9190255
2017,Tuvalu,Oceania,167140,713910,546770
2017,Vanuatu,Oceania,5563652,4682040,-881612
2017,Wallis and Futuna,Oceania,22594,137027,114433
2017,Samoa,Oceania,5973991,48253933,42279942
2017,Argentina,South America,4630963000,8354319697,3723356697
2017,Bolivia,South America,680956640,646525977,-34430663
2017,Brazil,South America,27387017888,29721315877,2334297989
2017,Chile,South America,10256244625,11648262880,1392018255
2017,Colombia,South America,11118562112,12553611745,1435049633
2017,Ecuador,South America,5968054311,4281889388,-1686164923
2017,Falkland Islands,South America,11243175,437315,-10805860
2017,Guyana,South America,301874215,430484780,128610565
2017,Peru,South America,6936997645,8179591388,1242593743
2017,Paraguay,South America,127885762,1779113252,1651227490
2017,Suriname,South America,54221918,353021996,298800078
2017,Uruguay,South America,473833837,1114358052,640524215
2017,Venezuela,South America,11479325124,3967611414,-7511713710
2018,Angola,Africa,2150654390,628367085,-1522287305
2018,Burundi,Africa,13937722,16194243,2256521
2018,Benin,Africa,26326501,262522403,236195902
2018,Burkina Faso,Africa,8961484,142837264,133875780
2018,Botswana,Africa,226856625,66839667,-160016958
2018,Central African Republic,Africa,2830518,17612066,14781548
2018,Cote d'Ivoire,Africa,1164518685,396627902,-767890783
2018,Cameroon,Africa,216581125,255574900,38993775
2018,Democratic Republic of the Congo,Africa,44079612,2047678687,2003599075
2018,Republic of the Congo,Africa,457107818,104499998,-352607820
2018,Comoros,Africa,2987233,940778,-2046455
2018,Cape Verde,Africa,4154463,19062747,14908284
2018,Djibouti,Africa,1964399,100060728,98096329
2018,Algeria,Africa,4273565992,1066699060,-3206866932
2018,Egypt,Africa,2670297274,5073329769,2403032495
2018,Eritrea,Africa,186256,7886001,7699745
2018,Ethiopia,Africa,307174897,1337942208,1030767311
2018,Gabon,Africa,260825871,97679471,-163146400
2018,Ghana,Africa,586026912,861725936,275699024
2018,Guinea,Africa,5106118,112082511,106976393
2018,Gambia,Africa,654799,42478212,41823413
2018,Guinea-Bissau,Africa,175055,18230825,18055770
2018,Equatorial Guinea,Africa,530457749,134919890,-395537859
2018,Kenya,Africa,575954968,434277663,-141677305
2018,Liberia,Africa,61576869,185617729,124040860
2018,Libya,Africa,956368208,238427600,-717940608
2018,Lesotho,Africa,373301844,8743828,-364558016
2018,Morocco,Africa,1496606338,3846218450,2349612112
2018,Madagascar,Africa,717794816,150355747,-567439069
2018,Mali,Africa,23313599,119680492,96366893
2018,Mozambique,Africa,126633530,286852355,160218825
2018,Mauritania,Africa,6487671,100375263,93887592
2018,Mauritius,Africa,321099150,161375304,-159723846
2018,Malawi,Africa,52818429,40599198,-12219231
2018,Namibia,Africa,127144656,163969866,36825210
2018,Niger,Africa,38605530,126618418,88012888
2018,Nigeria,Africa,5735313174,2664449370,-3070863804
2018,Rwanda,Africa,74676722,42141295,-32535427
2018,Sudan,Africa,19897314,129263349,109366035
2018,Senegal,Africa,139131484,309036325,169904841
2018,Saint Helena,Africa,13512965,687587,-12825378
2018,Sierra Leone,Africa,55486126,84708126,29222000
2018,Somalia,Africa,1304583,47194855,45890272
2018,South Sudan,Africa,15594,22879672,22864078
2018,Sao Tome and Principe,Africa,706225,3256118,2549893
2018,Eswatini,Africa,14876494,27723157,12846663
2018,Seychelles,Africa,9253847,19125651,9871804
2018,Chad,Africa,433791707,50247724,-383543983
2018,Togo,Africa,11450042,661058666,649608624
2018,Tunisia,Africa,580157037,690931987,110774950
2018,Tanzania,Africa,208000865,234609547,26608682
2018,Uganda,Africa,57963027,98078076,40115049
2018,South Africa,Africa,7086408054,5173924348,-1912483706
2018,Zambia,Africa,152928057,176120013,23191956
2018,Zimbabwe,Africa,75123924,46207239,-28916685
2018,French South Antarctic Territory,Antarctica,23520,804609,781089
2018,Afghanistan,Asia,27199982,1150662318,1123462336
2018,United Arab Emirates,Asia,5248367138,17108296107,11859928969
2018,Armenia,Asia,55369138,151985876,96616738
2018,Azerbaijan,Asia,338968459,450047407,111078948
2018,Bangladesh,Asia,6274171087,1750293532,-4523877555
2018,Bahrain,Asia,901388829,1054532097,153143268
2018,Brunei,Asia,54415098,245654922,191239824
2018,Bhutan,Asia,784608,3334181,2549573
2018,Cocos (Keeling) Islands,Asia,2894738,339713,-2555025
2018,China,Asia,5.03949E+11,1.17809E+11,-3.86139E+11
2018,Christmas Island,Asia,872552,736259,-136293
2018,Cyprus,Asia,106120964,110329923,4208959
2018,Georgia,Asia,190124828,568181547,378056719
2018,Hong Kong,Asia,4260509175,34683183225,30422674050
2018,Indonesia,Asia,19976334737,8450303404,-11526031333
2018,India,Asia,52551424104,31699514176,-20851909928
2018,British Indian Ocean Territory,Asia,99601,8935901,8836300
2018,Iran,Asia,67737169,451813405,384076236
2018,Iraq,Asia,10658457982,1261532999,-9396924983
2018,Israel,Asia,19368165289,9094718947,-10273446342
2018,Jordan,Asia,1670710214,1578285868,-92424346
2018,Japan,Asia,1.34426E+11,73446976650,-60979014864
2018,Kazakhstan,Asia,1390521135,999326388,-391194747
2018,Kyrgyzstan,Asia,8247823,94386228,86138405
2018,Cambodia,Asia,4112750319,493153477,-3619596842
2018,South Korea,Asia,73200290689,55910176692,-17290113997
2018,Kuwait,Asia,1767190827,3032443211,1265252384
2018,Laos,Asia,141200446,22813991,-118386455
2018,Lebanon,Asia,83213371,1418797451,1335584080
2018,Sri Lanka,Asia,2752192591,358566573,-2393626018
2018,Macau,Asia,48028739,311286986,263258247
2018,Maldives,Asia,19703705,45179194,25475489
2018,Burma,Asia,677990529,322658438,-355332091
2018,Mongolia,Asia,9697359,185753452,176056093
2018,Malaysia,Asia,29738236909,12592491713,-17145745196
2018,Nepal,Asia,110049877,77136245,-32913632
2018,Oman,Asia,1051622808,1379136475,327513667
2018,Pakistan,Asia,3840420518,2829130854,-1011289664
2018,Philippines,Asia,13707402084,9099064262,-4608337822
2018,Palestine,Asia,13807449,55154146,41346697
2018,Qatar,Asia,1419659283,5098429627,3678770344
2018,Saudi Arabia,Asia,22315772120,13138464711,-9177307409
2018,Singapore,Asia,24587394319,30145425039,5558030720
2018,Syria,Asia,5015581,5275415,259834
2018,Thailand,Asia,28981406835,12917520886,-16063885949
2018,Tajikistan,Asia,1257838,34823269,33565431
2018,Turkmenistan,Asia,7927407,28443507,20516100
2018,Timor-Leste,Asia,7201242,1393660,-5807582
2018,Turkey,Asia,9099404887,10903892818,1804487931
2018,Uzbekistan,Asia,8851351,306475745,297624394
2018,Vietnam,Asia,48078570258,9964633179,-38113937079
2018,Chinese Taipei,Asia,42116572470,31265242011,-10851330459
2018,Yemen,Asia,2103013,240051457,237948444
2018,Albania,Europe,63453690,61245364,-2208326
2018,Andorra,Europe,15837866,3017675,-12820191
2018,Austria,Europe,12563946869,4671428275,-7892518594
2018,Belgium,Europe,18249106942,25494927529,7245820587
2018,Bulgaria,Europe,767667387,360765309,-406902078
2018,Bosnia and Herzegovina,Europe,94287778,257425010,163137232
2018,Belarus,Europe,310427321,317838629,7411308
2018,Switzerland,Europe,38301853193,21186082891,-17115770302
2018,Czechia,Europe,4157647565,3625525469,-532122096
2018,Germany,Europe,1.30808E+11,54268102611,-76539647821
2018,Denmark,Europe,8713560185,2534054697,-6179505488
2018,Spain,Europe,15682772239,13671833530,-2010938709
2018,Estonia,Europe,1218574467,379225004,-839349463
2018,Finland,Europe,5374634789,1997728433,-3376906356
2018,France,Europe,45479871654,26980965801,-18498905853
2018,United Kingdom,Europe,59514541274,51089666555,-8424874719
2018,Gibraltar,Europe,352166,990254975,989902809
2018,Greece,Europe,1773350131,833734344,-939615787
2018,Croatia,Europe,438998434,411928482,-27069952
2018,Hungary,Europe,3837798878,1868911137,-1968887741
2018,Ireland,Europe,49140536769,17601792397,-31538744372
2018,Iceland,Europe,405287509,559465415,154177906
2018,Italy,Europe,50082614684,19111186363,-30971428321
2018,Lithuania,Europe,1518442734,579725111,-938717623
2018,Luxembourg,Europe,500948474,974112510,473164036
2018,Latvia,Europe,648375341,384743411,-263631930
2018,Moldova,Europe,50117185,61397809,11280624
2018,North Macedonia,Europe,310431229,205242310,-105188919
2018,Malta,Europe,198084128,261822392,63738264
2018,Montenegro,Europe,2235237,71242225,69006988
2018,Netherlands,Europe,24834037041,45024641280,20190604239
2018,Norway,Europe,6015969086,5687903853,-328065233
2018,Poland,Europe,7147645824,5140567803,-2007078021
2018,Portugal,Europe,3725001559,1707909088,-2017092471
2018,Romania,Europe,1981306595,1121932642,-859373953
2018,Russia,Europe,17944902450,8693594673,-9251307777
2018,San Marino,Europe,11349217,1539844,-9809373
2018,Serbia,Europe,303456385,334350898,30894513
2018,Slovakia,Europe,3407698354,546506885,-2861191469
2018,Slovenia,Europe,709629630,763536040,53906410
2018,Sweden,Europe,11022203413,4478408410,-6543795003
2018,Ukraine,Europe,1247069005,2449744653,1202675648
2018,Aruba,North America,11380306,612757518,601377212
2018,Anguilla,North America,4948677,99078162,94129485
2018,Antigua and Barbuda,North America,6137178,397689480,391552302
2018,Bahamas,North America,449435759,2743440801,2294005042
2018,Belize,North America,79167049,389091986,309924937
2018,Bermuda,North America,13817709,516227709,502410000
2018,Barbados,North America,115423472,595471307,480047835
2018,Canada,North America,3.1574E+11,2.60636E+11,-55104379863
2018,Costa Rica,North America,4665611207,6227198806,1561587599
2018,Cuba,North America,1275914,254238718,252962804
2018,Curaçao,North America,102079452,647128969,545049517
2018,Cayman Islands,North America,13850173,627400045,613549872
2018,Dominica,North America,1192202,129585136,128392934
2018,Dominican Republic,North America,5251141436,8787078202,3535936766
2018,Grenada,North America,10478246,158527539,148049293
2018,Greenland,North America,16259006,9316055,-6942951
2018,Guatemala,North America,4117688599,6827510783,2709822184
2018,Honduras,North America,3184372243,4938665479,1754293236
2018,Haiti,North America,1007354792,966772311,-40582481
2018,Jamaica,North America,602612607,2502720649,1900108042
2018,Saint Kitts and Nevis,North America,40265238,181049357,140784119
2018,Saint Lucia,North America,47088754,592555389,545466635
2018,Saint Martin,North America,2218220,631861005,629642785
2018,Mexico,North America,3.48375E+11,2.45484E+11,-1.02891E+11
2018,Montserrat,North America,802089,10570974,9768885
2018,Nicaragua,North America,3155617644,1664998146,-1490619498
2018,Panama,North America,261749511,6151255609,5889506098
2018,El Salvador,North America,2650805141,3369133174,718328033
2018,Saint Pierre and Miquelon,North America,9604,112317,102713
2018,Turks and Caicos Islands,North America,3589345,203001642,199412297
2018,Trinidad and Tobago,North America,3347582849,1894271407,-1453311442
2018,Saint Vincent and the Grenadines,North America,7146085,116557089,109411004
2018,British Virgin Islands,North America,14703135,385749736,371046601
2018,Australia,Oceania,9832375489,23298854357,13466478868
2018,Cook Islands,Oceania,911535,4428794,3517259
2018,Fiji,Oceania,322786381,61606471,-261179910
2018,Micronesia,Oceania,771940,37715119,36943179
2018,Kiribati,Oceania,3077426,3377327,299901
2018,Marshall Islands,Oceania,11771989,258003479,246231490
2018,New Caledonia,Oceania,54626024,50369696,-4256328
2018,Norfolk Island,Oceania,718472,179163,-539309
2018,Niue,Oceania,334616,1193223,858607
2018,Nauru,Oceania,2662446,760618,-1901828
2018,New Zealand,Oceania,3874843805,3677926020,-196917785
2018,Pitcairn Islands,Oceania,7265,80179,72914
2018,Palau,Oceania,1192474,46082172,44889698
2018,Papua New Guinea,Oceania,80021627,73558068,-6463559
2018,French Polynesia,Oceania,30902450,605993869,575091419
2018,Solomon Islands,Oceania,4629003,12284920,7655917
2018,Tokelau,Oceania,4682876,3370079,-1312797
2018,Tonga,Oceania,3439423,19021106,15581683
2018,Tuvalu,Oceania,51554,1213006,1161452
2018,Vanuatu,Oceania,7137785,6033390,-1104395
2018,Wallis and Futuna,Oceania,15720,1021123,1005403
2018,Samoa,Oceania,8212130,40997305,32785175
2018,Argentina,South America,4494212647,8209624775,3715412128
2018,Bolivia,South America,564337289,559650412,-4686877
2018,Brazil,South America,29271148561,33355770664,4084622103
2018,Chile,South America,10601220230,13794528839,3193308609
2018,Colombia,South America,11477602781,13673740713,2196137932
2018,Ecuador,South America,6648826603,5402739476,-1246087127
2018,Falkland Islands,South America,12422106,199770,-12222336
2018,Guyana,South America,157174636,561790467,404615831
2018,Peru,South America,8101351408,9212293134,1110941726
2018,Paraguay,South America,135166613,1748302678,1613136065
2018,Suriname,South America,71592446,362047393,290454947
2018,Uruguay,South America,437046229,935650887,498604658
2018,Venezuela,South America,12169415147,5973515152,-6195899995
2019,Angola,Africa,1010230787,603478698,-406752089
2019,Burundi,Africa,10092185,11359159,1266974
2019,Benin,Africa,18516427,269616953,251100526
2019,Burkina Faso,Africa,7395103,183218542,175823439
2019,Botswana,Africa,119830740,114363323,-5467417
2019,Central African Republic,Africa,3389243,33528566,30139323
2019,Cote d'Ivoire,Africa,891583341,398057788,-493525553
2019,Cameroon,Africa,301222738,190864391,-110358347
2019,Democratic Republic of the Congo,Africa,22689690,1992407443,1969717753
2019,Republic of the Congo,Africa,229219093,111299874,-117919219
2019,Comoros,Africa,2044021,1454228,-589793
2019,Cape Verde,Africa,3457547,14742953,11285406
2019,Djibouti,Africa,2587530,140385892,137798362
2019,Algeria,Africa,2304739012,975288842,-1329450170
2019,Egypt,Africa,3396591066,5067639965,1671048899
2019,Eritrea,Africa,120934,13790124,13669190
2019,Ethiopia,Africa,477134128,412110612,-65023516
2019,Gabon,Africa,106742823,126904880,20162057
2019,Ghana,Africa,948681801,929954378,-18727423
2019,Guinea,Africa,6559845,112254731,105694886
2019,Gambia,Africa,634445,48854846,48220401
2019,Guinea-Bissau,Africa,1859783,1179612,-680171
2019,Equatorial Guinea,Africa,303908458,210727810,-93180648
2019,Kenya,Africa,534062597,449708050,-84354547
2019,Liberia,Africa,67431630,107284141,39852511
2019,Libya,Africa,1391611917,405958684,-985653233
2019,Lesotho,Africa,291491987,2077168,-289414819
2019,Morocco,Africa,1381750563,3655610375,2273859812
2019,Madagascar,Africa,627831495,63573458,-564258037
2019,Mali,Africa,14700822,129880627,115179805
2019,Mozambique,Africa,131010354,225056121,94045767
2019,Mauritania,Africa,3547299,110028144,106480845
2019,Mauritius,Africa,312234970,119248273,-192986697
2019,Malawi,Africa,88086557,36884555,-51202002
2019,Namibia,Africa,132727802,187956478,55228676
2019,Niger,Africa,11083980,128691679,117607699
2019,Nigeria,Africa,4675491463,3208693046,-1466798417
2019,Rwanda,Africa,47410321,38623984,-8786337
2019,Sudan,Africa,22712454,73368521,50656067
2019,Senegal,Africa,146357449,223964959,77607510
2019,Saint Helena,Africa,10799541,560061,-10239480
2019,Sierra Leone,Africa,27327808,73925292,46597484
2019,Somalia,Africa,1052902,102243071,101190169
2019,South Sudan,Africa,70376259,21783654,-48592605
2019,Sao Tome and Principe,Africa,1029362,4034849,3005487
2019,Eswatini,Africa,24313612,34164198,9850586
2019,Seychelles,Africa,12449539,22541583,10092044
2019,Chad,Africa,119387798,77638193,-41749605
2019,Togo,Africa,13270023,444715279,431445256
2019,Tunisia,Africa,406785919,556150360,149364441
2019,Tanzania,Africa,128194022,149225184,21031162
2019,Uganda,Africa,62804731,102922916,40118185
2019,South Africa,Africa,6815483391,5433013974,-1382469417
2019,Zambia,Africa,60078344,154969375,94891031
2019,Zimbabwe,Africa,43156192,51540671,8384479
2019,French South Antarctic Territory,Antarctica,126265,1691560,1565295
2019,Afghanistan,Asia,35972266,962201811,926229545
2019,United Arab Emirates,Asia,4665243000,16518287373,11853044373
2019,Armenia,Asia,64955934,117315999,52360065
2019,Azerbaijan,Asia,26120350,295823059,269702709
2019,Bangladesh,Asia,6860507527,1627968391,-5232539136
2019,Bahrain,Asia,1044946727,858977045,-185969682
2019,Brunei,Asia,40500742,222652524,182151782
2019,Bhutan,Asia,549079,2746827,2197748
2019,Cocos (Keeling) Islands,Asia,2595674,78773,-2516901
2019,China,Asia,4.29334E+11,1.02922E+11,-3.26412E+11
2019,Christmas Island,Asia,468754,1494545,1025791
2019,Cyprus,Asia,78623809,171912861,93289052
2019,Georgia,Asia,154420078,804183045,649762967
2019,Hong Kong,Asia,2946631193,28461210777,25514579584
2019,Indonesia,Asia,19255797582,7873310328,-11382487254
2019,India,Asia,55517851010,33914361367,-21603489643
2019,British Indian Ocean Territory,Asia,775673,22433598,21657925
2019,Iran,Asia,1438552,73133366,71694814
2019,Iraq,Asia,6356183669,1209440217,-5146743452
2019,Israel,Asia,17707365995,13222302369,-4485063626
2019,Jordan,Asia,1876690895,1326345118,-550345777
2019,Japan,Asia,1.32766E+11,69566969327,-63199237692
2019,Kazakhstan,Asia,1184389576,1134846163,-49543413
2019,Kyrgyzstan,Asia,5877915,63125178,57247263
2019,Cambodia,Asia,5969572431,560324604,-5409247827
2019,South Korea,Asia,74761305614,57599018352,-17162287262
2019,Kuwait,Asia,1160899896,3200622931,2039723035
2019,Laos,Asia,149185438,54379083,-94806355
2019,Lebanon,Asia,92419865,1592425352,1500005487
2019,Sri Lanka,Asia,3080518843,498149764,-2582369079
2019,Macau,Asia,54863133,302620652,247757519
2019,Maldives,Asia,18466670,49070404,30603734
2019,Burma,Asia,972301129,407181449,-565119680
2019,Mongolia,Asia,28096564,261123262,233026698
2019,Malaysia,Asia,29905770436,12840402789,-17065367647
2019,Nepal,Asia,106921552,138100606,31179054
2019,Oman,Asia,1115100247,1488723313,373623066
2019,Pakistan,Asia,3894167632,2623354935,-1270812697
2019,Philippines,Asia,11992742759,7949845100,-4042897659
2019,Palestine,Asia,20808697,60874322,40065625
2019,Qatar,Asia,1254671305,4920781421,3666110116
2019,Saudi Arabia,Asia,12216510629,13321488676,1104978047
2019,Singapore,Asia,24647416062,28623864968,3976448906
2019,Syria,Asia,5727116,4045607,-1681509
2019,Thailand,Asia,31473775043,12947624758,-18526150285
2019,Tajikistan,Asia,3005288,20388481,17383193
2019,Turkmenistan,Asia,13596796,25692818,12096022
2019,Timor-Leste,Asia,4927054,4592774,-334280
2019,Turkey,Asia,9431878000,10391925675,960047675
2019,Uzbekistan,Asia,12106334,537735719,525629385
2019,Vietnam,Asia,63615690825,10728753340,-52886937485
2019,Chinese Taipei,Asia,49140727151,30102288456,-19038438695
2019,Yemen,Asia,4584704,383489416,378904712
2019,Albania,Europe,45740052,85049834,39309782
2019,Andorra,Europe,12182625,3298945,-8883680
2019,Austria,Europe,11747307699,6385863028,-5361444671
2019,Belgium,Europe,22070406533,28800793399,6730386866
2019,Bulgaria,Europe,764368551,384016698,-380351853
2019,Bosnia and Herzegovina,Europe,102927576,258262413,155334837
2019,Belarus,Europe,215809629,342256989,126447360
2019,Switzerland,Europe,41322783851,18223175942,-23099607909
2019,Czechia,Europe,4562087495,3384594028,-1177493467
2019,Germany,Europe,1.29804E+11,58990792577,-70812922809
2019,Denmark,Europe,11267345337,3002542542,-8264802795
2019,Spain,Europe,16165229178,15056762149,-1108467029
2019,Estonia,Europe,1113089486,413278647,-699810839
2019,Finland,Europe,6155018189,2065217223,-4089800966
2019,France,Europe,46678693568,28712361287,-17966332281
2019,United Kingdom,Europe,64006427762,50810363742,-13196064020
2019,Gibraltar,Europe,9020331,1048530147,1039509816
2019,Greece,Europe,1644933710,1189787939,-455145771
2019,Croatia,Europe,502747865,561284122,58536257
2019,Hungary,Europe,3817671307,2072679374,-1744991933
2019,Ireland,Europe,51295046139,14174503772,-37120542367
2019,Iceland,Europe,405843917,444985924,39142007
2019,Italy,Europe,50097265173,19588268502,-30508996671
2019,Lithuania,Europe,1183825555,700099377,-483726178
2019,Luxembourg,Europe,566845885,1037410921,470565036
2019,Latvia,Europe,403867233,286698328,-117168905
2019,Moldova,Europe,56536538,63247172,6710634
2019,North Macedonia,Europe,230370021,279717696,49347675
2019,Malta,Europe,177167578,157065240,-20102338
2019,Montenegro,Europe,3383400,34420004,31036604
2019,Netherlands,Europe,26209158994,47559869874,21350710880
2019,Norway,Europe,4800584870,5305348415,504763545
2019,Poland,Europe,7566612200,6594944767,-971667433
2019,Portugal,Europe,3561831133,1628983627,-1932847506
2019,Romania,Europe,1761182685,971325968,-789856717
2019,Russia,Europe,19823211853,9071510635,-10751701218
2019,San Marino,Europe,11641321,726689,-10914632
2019,Serbia,Europe,368685558,425731144,57045586
2019,Slovakia,Europe,3462584854,662496391,-2800088463
2019,Slovenia,Europe,702699347,559891663,-142807684
2019,Sweden,Europe,11530606787,4555705749,-6974901038
2019,Ukraine,Europe,1132106626,2729400819,1597294193
2019,Aruba,North America,9219924,443001429,433781505
2019,Anguilla,North America,1998099,76746777,74748678
2019,Antigua and Barbuda,North America,6264174,376664865,370400691
2019,Bahamas,North America,209310088,2948383404,2739073316
2019,Belize,North America,75371710,401137127,325765417
2019,Bermuda,North America,24094180,559160130,535065950
2019,Barbados,North America,99485928,550904878,451418950
2019,Canada,North America,3.14225E+11,2.53102E+11,-61122934172
2019,Costa Rica,North America,4902158649,6035643748,1133485099
2019,Cuba,North America,2583480,279474239,276890759
2019,Curaçao,North America,66829275,369348116,302518841
2019,Cayman Islands,North America,32903482,703538485,670635003
2019,Dominica,North America,1185643,322510364,321324721
2019,Dominican Republic,North America,5738367765,9266172917,3527805152
2019,Grenada,North America,9494299,150733673,141239374
2019,Greenland,North America,25004568,11039103,-13965465
2019,Guatemala,North America,4178511561,6869543070,2691031509
2019,Honduras,North America,4101795881,5113485181,1011689300
2019,Haiti,North America,1083479925,973162302,-110317623
2019,Jamaica,North America,606549551,2574015096,1967465545
2019,Saint Kitts and Nevis,North America,42263688,185171036,142907348
2019,Saint Lucia,North America,36755237,564438653,527683416
2019,Saint Martin,North America,6739549,651863366,645123817
2019,Mexico,North America,3.59525E+11,2.3488E+11,-1.24645E+11
2019,Montserrat,North America,1255230,11313270,10058040
2019,Nicaragua,North America,3405150724,1771038066,-1634112658
2019,Panama,North America,308218792,7204408653,6896189861
2019,El Salvador,North America,2523608272,3239803811,716195539
2019,Saint Pierre and Miquelon,North America,29204,72789,43585
2019,Turks and Caicos Islands,North America,2162511,200478709,198316198
2019,Trinidad and Tobago,North America,3152543360,2596393244,-556150116
2019,Saint Vincent and the Grenadines,North America,8081841,120006874,111925033
2019,British Virgin Islands,North America,1562406,342251390,340688984
2019,Australia,Oceania,10293243213,24501948000,14208704787
2019,Cook Islands,Oceania,474100,7444310,6970210
2019,Fiji,Oceania,374083704,72362644,-301721060
2019,Micronesia,Oceania,1576377,38204673,36628296
2019,Kiribati,Oceania,2877090,1357410,-1519680
2019,Marshall Islands,Oceania,9449038,88303608,78854570
2019,New Caledonia,Oceania,41965466,59373562,17408096
2019,Norfolk Island,Oceania,77371,11710,-65661
2019,Niue,Oceania,339136,239877,-99259
2019,Nauru,Oceania,4072968,1166496,-2906472
2019,New Zealand,Oceania,3789378407,3571080269,-218298138
2019,Pitcairn Islands,Oceania,12288,3372,-8916
2019,Palau,Oceania,1594889,16886263,15291374
2019,Papua New Guinea,Oceania,65786797,81518738,15731941
2019,French Polynesia,Oceania,38326446,478585889,440259443
2019,Solomon Islands,Oceania,5124917,11010429,5885512
2019,Tokelau,Oceania,900164,158864,-741300
2019,Tonga,Oceania,5599790,16241488,10641698
2019,Tuvalu,Oceania,117033,789444,672411
2019,Vanuatu,Oceania,6262264,2756951,-3505313
2019,Wallis and Futuna,Oceania,43798,443399,399601
2019,Samoa,Oceania,8166354,49011285,40844931
2019,Argentina,South America,4441670384,6736181084,2294510700
2019,Bolivia,South America,462718616,524490457,61771841
2019,Brazil,South America,30493225605,34897175851,4403950246
2019,Chile,South America,9743002842,13411479726,3668476884
2019,Colombia,South America,12414633091,13771121420,1356488329
2019,Ecuador,South America,6742185652,4196060436,-2546125216
2019,Falkland Islands,South America,18202562,295863,-17906699
2019,Guyana,South America,107984578,749543910,641559332
2019,Peru,South America,5758855910,8769534744,3010678834
2019,Paraguay,South America,189386399,2292934301,2103547902
2019,Suriname,South America,76284340,384670735,308386395
2019,Uruguay,South America,430933315,1014550683,583617368
2019,Venezuela,South America,1828829142,1227237627,-601591515
2020,Angola,Africa,430990785,453210930,22220145
2020,Burundi,Africa,4460449,11898673,7438224
2020,Benin,Africa,13128008,211996462,198868454
2020,Burkina Faso,Africa,9527263,213725253,204197990
2020,Botswana,Africa,175469232,43343511,-132125721
2020,Central African Republic,Africa,883729,20781164,19897435
2020,Cote d'Ivoire,Africa,866774902,203730730,-663044172
2020,Cameroon,Africa,401651544,189814326,-211837218
2020,Democratic Republic of the Congo,Africa,30333790,1374221688,1343887898
2020,Republic of the Congo,Africa,131079868,145454607,14374739
2020,Comoros,Africa,3238702,2372383,-866319
2020,Cape Verde,Africa,4755120,35216486,30461366
2020,Djibouti,Africa,2104009,167463420,165359411
2020,Algeria,Africa,443843194,705817183,261973989
2020,Egypt,Africa,2380145840,4821207524,2441061684
2020,Eritrea,Africa,271389,17987742,17716353
2020,Ethiopia,Africa,408879080,553734688,144855608
2020,Gabon,Africa,71951053,89542159,17591106
2020,Ghana,Africa,674188578,787197513,113008935
2020,Guinea,Africa,7363013,120419469,113056456
2020,Gambia,Africa,1050517,42305654,41255137
2020,Guinea-Bissau,Africa,918135,1784598,866463
2020,Equatorial Guinea,Africa,114283701,94832296,-19451405
2020,Kenya,Africa,495947960,411895849,-84052111
2020,Liberia,Africa,44861859,88467637,43605778
2020,Libya,Africa,197026546,291968864,94942318
2020,Lesotho,Africa,297136591,4230765,-292905826
2020,Morocco,Africa,1126264042,2243280315,1117016273
2020,Madagascar,Africa,503322200,63589833,-439732367
2020,Mali,Africa,1949443,94209955,92260512
2020,Mozambique,Africa,121828719,170646411,48817692
2020,Mauritania,Africa,5670075,134892948,129222873
2020,Mauritius,Africa,187061031,74690311,-112370720
2020,Malawi,Africa,42586777,25918297,-16668480
2020,Namibia,Africa,81682756,133363521,51680765
2020,Niger,Africa,22418611,266995665,244577054
2020,Nigeria,Africa,1691547064,4489719676,2798172612
2020,Rwanda,Africa,31424657,24665555,-6759102
2020,Sudan,Africa,85746299,66891436,-18854863
2020,Senegal,Africa,123957917,305225609,181267692
2020,Saint Helena,Africa,5151836,4757955,-393881
2020,Sierra Leone,Africa,30438828,69094954,38656126
2020,Somalia,Africa,487471,56387460,55899989
2020,South Sudan,Africa,111962,38946414,38834452
2020,Sao Tome and Principe,Africa,641748,711660,69912
2020,Eswatini,Africa,25931388,32176820,6245432
2020,Seychelles,Africa,9701456,19711118,10009662
2020,Chad,Africa,3383848,43905582,40521734
2020,Togo,Africa,20653926,327901263,307247337
2020,Tunisia,Africa,565231935,412112812,-153119123
2020,Tanzania,Africa,117792861,199677386,81884525
2020,Uganda,Africa,71567262,121564183,49996921
2020,South Africa,Africa,10243546529,4195494190,-6048052339
2020,Zambia,Africa,40413212,109138939,68725727
2020,Zimbabwe,Africa,37424802,58968365,21543563
2020,French South Antarctic Territory,Antarctica,73270,803256,729986
2020,Afghanistan,Asia,14974823,602882905,587908082
2020,United Arab Emirates,Asia,3515544823,13970585793,10455040970
2020,Armenia,Asia,74212642,64296194,-9916448
2020,Azerbaijan,Asia,31928524,273516596,241588072
2020,Bangladesh,Asia,6254484543,1790733154,-4463751389
2020,Bahrain,Asia,603893952,635368543,31474591
2020,Brunei,Asia,72584389,203154867,130570478
2020,Bhutan,Asia,390500,2791777,2401277
2020,Cocos (Keeling) Islands,Asia,1584234,113950,-1470284
2020,China,Asia,4.37757E+11,1.22364E+11,-3.15394E+11
2020,Christmas Island,Asia,451597,1870855,1419258
2020,Cyprus,Asia,83970363,83400552,-569811
2020,Georgia,Asia,125742376,628796714,503054338
2020,Hong Kong,Asia,4074732015,22086975516,18012243501
2020,Indonesia,Asia,19624675980,7590775789,-12033900191
2020,India,Asia,49674266130,26635964604,-23038301526
2020,British Indian Ocean Territory,Asia,161927,6521073,6359146
2020,Iran,Asia,3809691,36277981,32468290
2020,Iraq,Asia,2854114026,729347336,-2124766690
2020,Israel,Asia,14099336451,8030257425,-6069079026
2020,Jordan,Asia,2100388385,1339826231,-760562154
2020,Japan,Asia,1.12117E+11,63139179018,-48978257137
2020,Kazakhstan,Asia,965003296,851323406,-113679890
2020,Kyrgyzstan,Asia,5621925,86591805,80969880
2020,Cambodia,Asia,7245483036,395217746,-6850265290
2020,South Korea,Asia,74966759370,53431909571,-21534849799
2020,Kuwait,Asia,544361905,2253105793,1708743888
2020,Laos,Asia,104301762,19534214,-84767548
2020,Lebanon,Asia,181820648,856887479,675066831
2020,Sri Lanka,Asia,2605151054,458666975,-2146484079
2020,Macau,Asia,93190812,274546330,181355518
2020,Maldives,Asia,15712835,19263318,3550483
2020,Burma,Asia,1144498582,380772923,-763725659
2020,Mongolia,Asia,13383984,226343295,212959311
2020,Malaysia,Asia,33780677387,12427378557,-21353298830
2020,Nepal,Asia,89986923,83118848,-6868075
2020,Oman,Asia,798158796,1080345299,282186503
2020,Pakistan,Asia,4039768034,2775689295,-1264078739
2020,Philippines,Asia,10724357327,6844145012,-3880212315
2020,Palestine,Asia,16749431,67240950,50491519
2020,Qatar,Asia,909466884,2991124528,2081657644
2020,Saudi Arabia,Asia,8959652184,10788806176,1829153992
2020,Singapore,Asia,27622334903,25879200409,-1743134494
2020,Syria,Asia,9539288,2051141,-7488147
2020,Thailand,Asia,35274015621,11323396518,-23950619103
2020,Tajikistan,Asia,684015,14596233,13912218
2020,Turkmenistan,Asia,13117325,32618756,19501431
2020,Timor-Leste,Asia,4299965,9036955,4736990
2020,Turkey,Asia,10258263184,10692541246,434278062
2020,Uzbekistan,Asia,67439573,236261504,168821931
2020,Vietnam,Asia,76999749784,10167399265,-66832350519
2020,Chinese Taipei,Asia,54791179225,28907981488,-25883197737
2020,Yemen,Asia,3824922,308731699,304906777
2020,Albania,Europe,45826338,73722960,27896622
2020,Andorra,Europe,5405548,3616156,-1789392
2020,Austria,Europe,10606678649,4305747098,-6300931551
2020,Belgium,Europe,24658603789,22369007794,-2289595995
2020,Bulgaria,Europe,784347621,438257071,-346090550
2020,Bosnia and Herzegovina,Europe,83448514,197091018,113642504
2020,Belarus,Europe,203260056,343190187,139930131
2020,Switzerland,Europe,62016944051,19748349493,-42268594558
2020,Czechia,Europe,4414781100,3402549948,-1012231152
2020,Germany,Europe,1.15517E+11,59206697840,-56310444514
2020,Denmark,Europe,11295390044,2777962342,-8517427702
2020,Spain,Europe,14334993933,13679480017,-655513916
2020,Estonia,Europe,1338325908,425325756,-913000152
2020,Finland,Europe,6168124211,1928098457,-4240025754
2020,France,Europe,36713243097,23571701026,-13141542071
2020,United Kingdom,Europe,51655062393,48638166728,-3016895665
2020,Gibraltar,Europe,19943483,790164902,770221419
2020,Greece,Europe,1372211166,1162553480,-209657686
2020,Croatia,Europe,602224305,334835040,-267389265
2020,Hungary,Europe,3926289455,2135211084,-1791078371
2020,Ireland,Europe,57356312441,12614324653,-44741987788
2020,Iceland,Europe,372206337,329543109,-42663228
2020,Italy,Europe,47936756086,18216146410,-29720609676
2020,Lithuania,Europe,1410492877,781019851,-629473026
2020,Luxembourg,Europe,388598840,767728338,379129498
2020,Latvia,Europe,453859827,221092399,-232767428
2020,Moldova,Europe,52608222,56019454,3411232
2020,North Macedonia,Europe,143699908,213305325,69605417
2020,Malta,Europe,168350288,135159162,-33191126
2020,Montenegro,Europe,5515518,41960612,36445094
2020,Netherlands,Europe,23850357962,42679696622,18829338660
2020,Norway,Europe,3642274686,4191770442,549495756
2020,Poland,Europe,7676427988,5514020804,-2162407184
2020,Portugal,Europe,3313255223,1476696081,-1836559142
2020,Romania,Europe,1533175476,979760221,-553415255
2020,Russia,Europe,11864590726,5679958716,-6184632010
2020,San Marino,Europe,11895696,2009485,-9886211
2020,Serbia,Europe,414565928,366483462,-48082466
2020,Slovakia,Europe,3742468032,626000122,-3116467910
2020,Slovenia,Europe,676070488,511779219,-164291269
2020,Sweden,Europe,12692843436,4306758478,-8386084958
2020,Ukraine,Europe,1111890239,2164154650,1052264411
2020,Aruba,North America,6284810,342161949,335877139
2020,Anguilla,North America,1213994,41245960,40031966
2020,Antigua and Barbuda,North America,2635324,268632344,265997020
2020,Bahamas,North America,175063570,2573040747,2397977177
2020,Belize,North America,64477213,359172574,294695361
2020,Bermuda,North America,21339533,403815904,382476371
2020,Barbados,North America,50910852,561352448,510441596
2020,Canada,North America,2.64177E+11,2.17847E+11,-46330222805
2020,Costa Rica,North America,5186733672,5459046601,272312929
2020,Cuba,North America,4906222,172059133,167152911
2020,Curaçao,North America,20236445,298192880,277956435
2020,Cayman Islands,North America,11370919,571585420,560214501
2020,Dominica,North America,1037688,106080889,105043201
2020,Dominican Republic,North America,5346317410,7465718514,2119401104
2020,Grenada,North America,8033551,123223479,115189928
2020,Greenland,North America,29004475,6370520,-22633955
2020,Guatemala,North America,3874721475,6010462976,2135741501
2020,Honduras,North America,3966976251,3919870933,-47105318
2020,Haiti,North America,851914626,976019809,124105183
2020,Jamaica,North America,546660501,1751272570,1204612069
2020,Saint Kitts and Nevis,North America,39797065,119965946,80168881
2020,Saint Lucia,North America,7327357,561160698,553833341
2020,Saint Martin,North America,1728112,318379861,316651749
2020,Mexico,North America,3.25798E+11,1.96042E+11,-1.29756E+11
2020,Montserrat,North America,1415911,7233908,5817997
2020,Nicaragua,North America,3172420994,1509898484,-1662522510
2020,Panama,North America,238675328,5428771588,5190096260
2020,El Salvador,North America,2005293688,2703300132,698006444
2020,Saint Pierre and Miquelon,North America,31572,231405,199833
2020,Turks and Caicos Islands,North America,2907479,150711086,147803607
2020,Trinidad and Tobago,North America,2257585317,2183573625,-74011692
2020,Saint Vincent and the Grenadines,North America,5142534,67829578,62687044
2020,British Virgin Islands,North America,4407960,176025525,171617565
2020,Australia,Oceania,11591724421,24248031320,12656306899
2020,Cook Islands,Oceania,2442974,2707705,264731
2020,Fiji,Oceania,243963282,30414728,-213548554
2020,Micronesia,Oceania,2521891,50129095,47607204
2020,Kiribati,Oceania,2091109,1956670,-134439
2020,Marshall Islands,Oceania,30287385,128960565,98673180
2020,New Caledonia,Oceania,28964994,46462725,17497731
2020,Norfolk Island,Oceania,38619,10656141,10617522
2020,Niue,Oceania,484867,165570,-319297
2020,Nauru,Oceania,3724240,575641,-3148599
2020,New Zealand,Oceania,4354440093,2929676726,-1424763367
2020,Palau,Oceania,475892,18058467,17582575
2020,Papua New Guinea,Oceania,77684304,54668161,-23016143
2020,French Polynesia,Oceania,17458353,150220102,132761749
2020,Solomon Islands,Oceania,3298116,2873123,-424993
2020,Tokelau,Oceania,1043275,49841,-993434
2020,Tonga,Oceania,3122833,11903877,8781044
2020,Tuvalu,Oceania,40743,1592087,1551344
2020,Vanuatu,Oceania,5233171,4058326,-1174845
2020,Wallis and Futuna,Oceania,745888,122726,-623162
2020,Samoa,Oceania,4731857,24773962,20042105
2020,Argentina,South America,3469817015,5022290395,1552473380
2020,Bolivia,South America,330035975,489407402,159371427
2020,Brazil,South America,21851477960,29308045299,7456567339
2020,Chile,South America,9944870424,10678632207,733761783
2020,Colombia,South America,9554408625,11087790658,1533382033
2020,Ecuador,South America,4803852769,4232629438,-571223331
2020,Falkland Islands,South America,10999919,280492,-10719427
2020,Guyana,South America,780863293,662576168,-118287125
2020,Peru,South America,6355122378,6820601631,465479253
2020,Paraguay,South America,179613086,1037125859,857512773
2020,Suriname,South America,179460331,246023383,66563052
2020,Uruguay,South America,557994728,1026648829,468654101
2020,Venezuela,South America,170439706,1090562760,920123054
